best_title	translated
和团队去北极探险，有没有针对这方面的HUTS保险呢	和北极探险团队的小屋保险
最近在安邦长青树中看到什么豁免，这个是什么意思？	最近在引导他们,看看他们的免疫力,这是什么意思?
听说huts可以申请医疗垫付的，什么情况下可以批呢？	听说小屋可以申请医学进步,什么情况下可以批吗?
老婆买了安*长*树，她在网上投保的，以后缴费怎么办	妻子买了安* *树,她网上保险,后付款
去欧*出差，随身的物品比较多，有没有保障这个的保险	出差,去*随身携带的物品,有本保险的保证
端午我们准备要举行赛龙舟，说是要份保险，什么好	端午节我们准备举行赛龙舟,保险,有什么好处
HUTS中有没有适合帆船比赛的保险，我男朋友这周就要开始了	你有什么好保险小屋的帆船比赛,本周将启动我的男朋友吗
计划端午节和男朋友自驾去九*山，买保险三天要多少钱？	计划去九个端午节和男朋友开车*山,要花多少钱购买保险为三天。
小*买了份哆啦A保，说是没有纸质保单，怎么回事	小*买了哆啦A酒保说,没有纸政策,怎么回事
huts保险中有没有关于赛事的？怎么好多保险户外赛事都不保障	小屋的事件保险吗?
这个周末儿子有场拳击比赛，很担心安全，什么保险好	儿子这个周末有一场拳击比赛,很担心安全,什么样的保险
这个周末天气不错，看着心情舒坦，准备和朋友户外拓展，什么保险好	这个周末天气不错,看着心情舒适,户外发展,准备和朋友什么样的保险
我女朋友比较马虎，她这次一个人去美*玩，想给买份保险	我的女朋友是草率的,她玩这个去美容,想买保险
为什么要选择职业，我儿子还在上中学，怎么填安邦长青树的职业？	你为什么要选择一种职业,我的儿子还在高中的时候,如何填补它与常绿事业?
我和老婆单位都买了社保，现在她又要买什么哆啦A保，有必要吗	我和我的妻子通常买了社保,现在她想买朵拉,这是必要的
我空闲时间不多，老婆带着儿子两个人去周边玩一天，有什么保险呢?	我没有太多的时间,两人的妻子带着儿子玩一天左右,保险是什么?
哆啦A保对年龄有没有限制，10岁的小女孩可以买吗	哆啦A调酒师有年龄限制,10岁的女孩可以买
老婆已经买了其他的重疾险，还要投康惠保，能行吗	妻子买了其他严重疾病的风险,但康汇宝,会做的
老公喜欢抽烟，但是听说这样就投不了安*长青树了，是真的吗，什么意思？	丈夫喜欢抽烟,但是我听说你不能安*常绿,是真的,你是什么意思?
当前有没有可以针对第一现场救助的旅游保险呢	目前第一现场救援的旅行保险
是不是我在犹豫期退保了安邦长青树，就不给我保障了？	不是我的贷款业务,他们的犹豫没有给我安全吗?
康惠保在北*买的，现在人在山*，出险了是否可以理赔？	康汇宝买北*,*山,现在人能补偿索赔吗?
重疾险的缴费期限有什么用处，康惠保的缴费期限好不好	好是什么大病保险付款期限,康汇宝付款方式
谁知道,在海外务工,有什么保险可以保障?	在海外工作,谁知道呢,保险可以保证是什么?
去年下半年大叔买了哆啦A保，现在原位癌住院了，能不能理赔？	去年下半年的叔叔买了一个哆啦A保,原位癌在医院现在,你能索赔吗?
怎么儿子去留学前三个月没有医疗保障，怎么办？	如何儿子幼儿园三个月是否没有医保,怎么办?
想问下，如果重疾理赔后身故，哆啦A保还有身故赔偿金吗	想问下,如果严重的疾病称死后,哆啦A保和死亡赔偿
为什么我投保的弘康哆啦A保没有发票呢？	为什么我覆盖香港康哆啦A保没有发票?
康惠保是选择终身的好还是到70岁保障期好，为什么？	康汇宝是选择一个好的或70岁高龄的保修期是好的,为什么?
本周公司团建，去户外玩，huts保险有什么比较好	本周公司团队建设,去外面玩,小屋保险更好
和老婆去德*旅游，办签证要买保险，什么比较好？	和妻子去德*,购买保险,签证是什么更好?
什么是小额快赔，在huts保险中看到的	什么是小快速补偿,在小屋看到保险吗
安*长*树对各个地区可以投保的最高保额有限制吗？	安* *树每个区域的极限可以投保?
投了安*长*树几个月后，发现得了脑膜炎，这个可以报销吗	把安* *树几个月后,发现,脑膜炎,这可以报销
哆啦A保享有多次赔付，但患重疾理赔后，轻症和身故责任还有吗？	多拉保险多次支付,但在患有严重的疾病,轻微和死亡责任?
姐姐投了安*长*树，为啥只有电子保单？	安姐姐* *树,为什么只有电子保单?
打算周末和老公带儿子来场亲子游，有什么HUTS保险比较可靠？	将和丈夫儿子这个周末亲子游,小屋的保险是可靠的吗?
我女朋友是个导游，比较担心安全，请问什么领队责任险可以考虑？	我的女朋友是一个导游,更担心安全,您能告诉我行李的危险责任的领导人考虑吗?
女儿去欧*留学，刚开始几个月医保卡没有下来，什么保险可以补充？	女儿在*起初几个月学习医疗保险卡不下来,能补充什么保险?
去韩*游玩，有什么HUTS保险比较可靠	访问朝鲜。
想要去欧*游玩，不晓得什么样的保险比较合适	想去,不知道保险是更合适的
请问下，安*长青树有没有等待期，长不长？	对不起,安*常绿等待期,很长时间吗?
出国玩比较担心护照等随身物品安全，什么保险可以投？	出国玩更担心护照和其他财产安全,保险可以投吗?
请问下康惠保的缴费年限有哪些？	你能告诉我康汇宝缴费年限?
消费型重疾险适合哪些人群	消费者重疾病风险的人群
爱好喝点小酒，可以投长青树吗	爱好喝葡萄酒,可以与常绿
因为工作原因，乘坐飞机比较多，有哪些HUTS保险产品是适合坐飞机投保的?	乘飞机旅行,因为工作原因,更重要的是,什么是保险产品适用于被保险人的小屋坐飞机?
最近看到HUTS的小额快赔，有什么好处呢？	最近看到的小棚屋快速补偿,好吗?
请问huts可以承保30人的野外跑步赛事吗？	小屋可以覆盖30人运行野生事件吗?
儿子计划去美*游学三个月，其他都准备好了，现在想找款合适的保险	儿子计划去旅行了三个月,其他的都准备好了,现在想找到合适的保险
最近俱乐部有个羽毛球比赛，给参赛者选择什么huts保险好？	最近俱乐部有一个羽毛球比赛,给参与者选择小屋保险吗?
请问下攀岩徒步等户外运动，买什么保险较好？	什么攀岩步行在户外运动,如购买保险比较好?
我是个导游，近期带队很频繁，有什么保险可以投的？	我是一个导游,领导最近很频繁,保险可以是什么?
有谁知道康惠保申请得严不严格？	谁知道康汇宝应用程序严不严格?
刚投保的康*保，说还在等待期，什么意思	只是覆盖了康*表示,仍在等待期,你是什么意思
请问下什么是轻症，为什么原位癌却按照安邦长青树的轻症理赔？	请你告诉我为什么温和,原位癌和按照业务的轻度索赔?
下周儿子会有场小学生足球比赛，比较担心安全，可以买什么保险？	下周将会有一个儿子小学足球比赛是安全的,可以买保险吗?
老板安排我去美*出差一个月，什么保险比较安全	老板问我去出差了一个月,保险是什么安全
请问下哆啦A保重疾险,买多久的比较好?	请问哆啦A保健疾病风险,买多长时间比较好?
请问下HUTS旅游险和一般的旅游保险有什么不一样的？	请问小屋旅游风险和一般旅游保险有什么不同?
这个周末去周边玩，只有一天的时间，要不要买保险的	这个周末玩,只有一天,想买保险
出发前投了huts保险，如果迷路了怎么办呢？	保险小屋出发前,如果迷路了吗?
准备端午去日*玩玩,买了机票什么旅游险好	准备玩龙舟忘记*,什么是好的旅游保险买了票
最近在看重疾险，看到哆啦A保说什么智能核保，什么意思？	最近在疾病风险值,看看哆啦A保智能承销,你是什么意思?
谁晓得安邦长青树的保险单怎么拿到？	谁知道如何得到他们的业务策略?
今年28岁，投保哆啦A保多久比较好？	今年28岁,被保险人哆啦A保多长时间比较好?
陪老婆去巴*玩，有什么合适的旅游险比较好的？	陪妻子去玩*,适当的旅行保险是好吗?
中*人民健康保险中途退保可以全额退款吗	*人民健康保险拥有者可以全额退款
我老公比较忙，我可以为他投康惠保吗	我的丈夫很忙,我可以把康汇宝给他
买哆啦A保,之前还要去做个体检吗?	之前他们可以买朵拉,做身体检查吗?
在网上买了哆啦A保，保单在哪儿啊？	在网上买了一个哆啦A保,是政策?
青*6日游，除了必备品的准备外，保险需要购买哪些	绿色* 6日游,除了必要的准备,需要买什么保险
我老公特别喜欢喝酒，担心他身体健康，能买什么重疾险？	我的丈夫喜欢喝酒,担心他的健康,可以买什么沉重的疾病风险?
我大舅抽烟，可以买安邦长青树吗？	大舅抽烟,我可以和常绿买它吗?
准备这个星期去攀岩，有教练陪同再有保险可行？	本周准备攀岩,有教练陪同另一个保险可行吗?
现在市面上哪种重疾险比较好	什么样的严重疾病风险更好的现在市面上
安邦人寿保险保单查询参加保险后想退保可以吗？	想投降后查询保险业务人寿保险单可以吗?
去东*亚游玩几天时间，有什么huts保险比较好的？	去东*,玩几天,有什么好的小屋保险吗?
华夏保险交了一年的钱能退保吗	中国保险资金移交一年投降
计划去欧*探亲，有没有适合的保险介绍下	计划去拜访亲戚,有合适的保险
天热了，很想去潜水，除了装备、教练以及费用外还要什么保险？	炎热的一天,很想去潜水,除了设备,和教练会有什么样的保险和成本?
决定端午去西*自驾游，除了装备之外要什么保险	决定去西路,端午节除了设备任何保险
请问下，百年康惠保在投保的时候要注意什么？	对不起,一百年康汇宝当被保险人注意什么?
得过胰腺炎是不是不能买重疾险	胰腺炎并不是严重的疾病的风险
安*长*树*保*不*扣保费？	安* *不是* * *树按钮保险费?
想知道，我搬家了会影响到哆啦A保的赔偿等问题吗？	想知道,我移动会影响哆啦A保险的赔偿等问题?
慧择说保险百年人寿定制的康惠保重疾险究竟怎么样	回族表示,选择保险一百生命定制康威医疗疾病风险会发生什么
计划端午准备去新*兰探亲，买什么保险比较好？	计划端午节准备新的*参观,更好的购买保险是什么?
已经投保了HUTS保险，如果出险怎么报案呢？	已经小屋保险,如果采取出报告吗?
HUTS保险中说的第一现场救援，是什么意思？	小屋保险说在第一现场救援,是什么意思?
我能替我上小学的儿子以及丈夫买安邦长青树吗	我可以为我的儿子在上小学的时候,和她的丈夫与常绿
有谁知道，HUTS保险产品应该怎么购买才不亏呢？	谁知道呢,小屋的保险产品应该如何购买不失去?
这个五一趁着天气好，准备和兄弟一起登山，买什么保险好？	5月天,天气很好,准备和兄弟一起登山,买什么保险?
我是个导游，最近看到HUTS的领队责任险，这个好不好？	最近,我是一个导游,看到危险的小屋一个领导者的责任,这是好吗?
一直计划去北*玩玩，但是不知道买什么保险好？	*游戏已经计划去朝鲜,但是不知道买什么保险?
想知道，是不是投保康惠保没有出险很亏？	想知道,保险Kang汇宝不会或者摆脱危险很不足吗?
我签的安*长*树还在犹豫期，能退保吗？	我的安*长*树,毫不犹豫地投降?
哆啦A保的犹豫期是多久，我退会不会扣钱的？	哆啦A保的犹豫期很长,我要扣钱吗?
安*长青树陪不赔偿良性肿瘤呢？	安*不弥补良性肿瘤与他们吗?
huts旅游保险和一般的旅游险有什么不同？	小屋旅行保险和一般旅游保险的区别是什么?
想知道，HUTS保险的7*24小时服务随时在线怎么申请的？	想知道,小屋保险服务7 * 24小时在线随时如何申请?
谁能说说康惠保怎么样，朋友推荐能投保吗？	谁能告诉我如何Kang汇宝,朋友可以推荐保险吗?
准备去速降，教练买了众行天下，说还管紧急救援，是真的吗？	准备去下坡,教练买了全世界,说也管的紧急救援,这是真的吗?
请问下，什么是HUTS的小额快赔服务？	对不起,小屋的快捷支付服务是什么?
想知道，康惠保对投保者的职业有没有限制呢	想知道,康汇宝有限制保险行业
人在国外旅游，买了HUTS保险请问什么条件可以申请紧急救援	人出国旅行,买了小屋保险什么条件可以申请紧急援助,请
听说了HUTS的北斗无人区卫星定位,请问什么意思	听说过北斗七星的小屋无人区卫星定位,请问这是什么意思
请问下安邦长青树的犹豫期究竟是多长呢？	做生意在常绿的犹豫期是多久?
本周会参加一个野外赛跑比赛，买什么HUTS保险比较合适？	本周将会疯狂的种族,购买更合适的小屋保险是什么?
打算和女朋友进行一周的观光旅行，买什么HUTS保险好？	计划为一周的观光旅游和他的女朋友,买什么小屋保险吗?
想知道,哆啦A保在医院上有什么要求,有没有指定的?	想知道,多拉在医院有什么要求,有指定吗?
打算这个五一带女朋友自驾云*玩，什么保险合适？	去打女朋友开车五区云*,什么样的保险?
打算入手安邦长青树，但是怎么付款，每次都得去保险公司吗	如何开始与常绿,但支付,必须到保险公司每一次吗
请问一下，康惠保保险对职业有没有限制？	对不起,康汇宝保险限制的职业吗?
打算周末和老公儿子去迪士尼，什么保险适合我们的？	周末去迪斯尼的丈夫和儿子,我们的保险是什么?
听说了huts一日游只要1元钱，真的吗	听说一天的小屋只是1元钱,真的
想知道，太*山穿越线路有哪些，有没什么保险专门保障的	想知道,这就是*山越界,没有什么特殊的医疗保险
最近看到HUTS的众行天下-自行车运动保险，可不可靠？	最近看到世界的小屋——自行车保险,不可靠吗?
请问下，康惠保主要保障什么？	对不起,Kang汇宝主要安全吗?
出门旅游安全最重要，如何选择旅游险最划算	外出旅游安全是最重要的,如何选择旅游最具成本效益的风险
请问下，huts的小额快赔服务是什么意思？	对不起,小的快捷支付服务的小屋是什么意思?
现在天气比较好,这周末开始和小伙伴去青*旅游,有没有合适的保险?	现在天气好,周末和朋友去旅行,有正确的保险吗?
看到安*长*树感觉很适合自己，但是自己只有建行卡，可以支付吗？	看到安* *树觉得很适合自己,但是他们只有建设银行信用卡,你能支付吗?
儿子这学期就去纽*留学，请问买什么保险好？	儿子去了纽约*这学期学习,你能告诉我买什么保险?
本周末公司会组织一次大型户外拓展活动，200人什么HUTS保险合适？	这个周末,公司将组织一次大型户外推广活动,200小屋保险对吧?
最近看到一款新的重疾险，安*长青树保障范围怎么样	最近看到一个新的重疾病风险,安*常绿的报道
工作很忙，但是想要买康惠保，需要提前体检吗	工作很忙,但是想买康汇宝,提前需要医疗
什么情况下可以申请HUTS的医疗垫付？	什么情况下可以应用小屋医学进步吗?
准备去日*玩一周，买什么旅游险比较好？	准备一个忘记*玩一个星期,最好买旅行保险是什么?
请问下huts安达天下-慧择旅游保险有哪些保障呢	小屋安达世界——回族,请选择你有什么保证在旅行保险
康惠保只能保障到70岁吗	康汇宝只能保证到70年
HUTS保险野外搜救医疗上怎么处置？	如何处置现场救援的医疗小屋保险吗?
我女儿上初中并没有身份证，可以买安邦长青树吗？	我的女儿是在初中,没有身份证,可以买到用常绿吗?
去北美商务留学，请问有没有相关的HUTS保险？	在北美留学业务,有没有相关的小屋保险吗?
已经投了HUTS保险，但是遭遇紧急情况同行未成年子女怎么办	投票在小屋保险,但遇到紧急同行未成年子女
买了huts保险，就医后无法自行回到居住地怎么办？	买了保险的棚屋,治疗失败后回到住的地方吗?
什么情况下可以申请HUTS保险的境外旅行紧急援助服务？	什么情况下可以应用小屋保险海外旅行紧急援助服务?
有谁能说下，康惠保的基本保障责任？	谁能说,康的基本保证汇宝责任?
有谁知道，慧择旅游HUTS保险中的一日游保障足不足？	谁知道呢,回族人选择旅游小屋保险一日游的脚短缺?
安*长*树买的时候要选职业，可我儿子未成年，怎么办	安买* *树时应选择专业,但我的儿子是未成年人,如何去做
想了解下，安邦的长青树理赔难不难	想知道,声称他们很难
请问下，是不是康惠保保险合同签订之后，就无法修改了	对不起,这是康汇宝签订保险合同后,不能修改
哆啦A保的理赔金额超过支付限额怎么办？	哆啦A保证期索赔金额超过付款限制?
我老公是石油开采工程技术人员，买安*长*树*险*不*被拒绝?	我的丈夫是一个钻井工程和技术人员,只买一个* * *树*不*被拒绝?
请问下安邦长青树的理赔超过直付限额怎么办	做生意比直接支付限制常绿下索赔吗
请问有哪位知道安*长青树赔偿款多长时间能到账	任何人都知道安*多长时间发送补偿他们的帐户吗
下周我会参加帆船比赛，请问什么保险比较可靠点	下周我将参加帆船,你能告诉我什么样的保险是可靠的
准备周末和孩子一起参加户外亲自活动，买什么保险比较好	周末和孩子参加户外活动,买什么保险好
康惠保的保额最高额和最低是多少呢？	康汇宝数量、最大和最小是多少?
有谁知道康惠保是哪种类型重疾	谁知道什么样的类型是康汇宝严重疾病
打算过阵子陪儿子去上海迪士尼玩，有合适的保险吗	打算在上海天陪儿子玩,有合适的保险
国内旅游，有没有领队责任险	国内旅游,有什么危险的一个领导者的责任
请问huts保险，境外需要及时了解护照，签证等信息怎么办？	小屋,在需要知道及时的护照、签证和其他信息吗?
投了huts保险，就医后无法正常走动但要回国怎么办？	保险的小屋,无法就医正常行走但回家吗?
huts保险境外需紧急就医而周边没有医疗机构怎么办？	小屋海外保险需要紧急治疗和周围没有医疗机构?
请问下huts保险中的7*24小时便捷服务是什么意思	请问保险的小屋和7 * 24小时服务是什么意思
有没有人晓得康惠保出现报案的话，要提供什么线索呢	有人知道康汇宝似乎报告,提供线索,什么
长青树保险的轻症给付可以累计几次呢	轻微的常绿保险付款可以积累几次
请问下安邦长青树中的绿通服务是什么意思？不懂	做生意的常绿乔木下绿色服务是什么意思?
安邦的重疾险长青树付款方式必须要现金吗	重疾病风险的常绿必须现金支付
老妈买了康惠保，但是只要电子保单，这是真的吗	妈妈买了康汇宝,但只要电子保单,是真的
百年的康惠保重疾险购买人群限制在成人吗？	康威医疗疾病风险购买一百人口限制在成人?
如何申请huts保险中的7*24小时便捷服务	如何申请保险的小屋方便7 * 24小时服务吗
HUTS中的众行天下可以有哪些保障,意外伤害有赔偿吗?	小屋在世界上可以有什么安全、事故赔偿吗?
请问下huts慧游游-慧择旅游保险是怎么理赔的？	请问小屋回族玉——回族如何选择旅游保险索赔?
huts保险可以保障哪些旅游呢？	小屋,旅游保险可以保证?
是不是康惠保不能给自己的闺蜜投？	康汇宝不能投票给他们的女朋友吗?
慧择的HUTS保险覆盖的范围多大？	回族选择保险范围的小屋?
想了解下,HUTS保险在旅游方面包括哪些类别？	想知道,小屋包括哪些类别的旅游保险?
huts保险在国内有哪些专属的搜救路线呢？	小屋保险什么独家的搜救路线在中国?
在投保哆啦A保的时候，需要明确哪些内容呢？	在投保的时候哆啦一个酒保,需要澄清什么?
请问下最近经常听过的康惠保保障的内容是什么	请问最近,经常听到康汇宝安全内容是什么
想知道哆啦A保的轻症可以赔付几次？	想知道哆啦A温和可以几次?
请问系huts保险中的小额快赔是什么意思？	对不起小棚屋保险快速补偿是什么意思?
工人是不是不能够买康惠保的？	工人将无法买康汇宝吗?
安*长*树的销售范围是什么？	安是* *树的范围的销售吗?
已经购买了huts保险，请问什么情况下可以申请全球救援	买了保险的小屋,你能告诉我什么情况下可以申请全球救援
想知道户外旅行遭遇紧急情况，亲属不在身边怎么办？	想知道户外旅行在紧急情况下,没有我的亲戚吗?
有了huts保险救援之后，同行的未成年子女怎么办	小屋保险救援后,同事的未成年子女
和女友准备野外露营几天，哪种好HUTS保险比较好？	和他的女朋友去野外露营几天,这是很好的小屋保险比较好?
请问下在外面旅游受伤治疗了,投了huts保险怎么回家	在外面旅游受伤治疗对不起,投票给小屋房屋保险
HUTS保险专属线路搜救，野外搜救怎么进行？	小屋保险如何独占行搜救,户外搜索和救援?
huts保险中有没有户外登山的保险呢	有户外运动保险在小屋保险吗
huts保险中有一日游的产品吗？哪个好点？	天旅游小屋保险产品?
请问有谁知道境外出游可以投保HUTS保险吗？	你们有谁能知道海外旅行保险的小屋吗?
请问已经投保HUTS保险，同行未成年儿子无人照料怎么办？	对不起,有保险的小屋,同行无人看管的十几岁的儿子?
想请问下白血病在不在安邦长青树的保障范围内	想请问白血病下跌超出经营范围的安全
请问huts保险中有什么保险用来留学的呢?	请告诉我什么是保险用于研究在国外小屋保险吗?
安*长青树理赔材料审核要多久呀	要多长时间才能安*声称他们的材料审查吗
想要保额高点，保障疾病种类全点的重疾险产品。	想要高,保障疾病保险产品的严重疾病的所有点。
同事给投的HUTS保险，需要救援的事故是怎么定的？	同事投票小屋保险,需要救援事故是怎么决定的?
想知道，huts保险遇到伤员是如何转运的？	想知道,小屋保险遇到受伤的是如何转移?
哥们买的huts保险，说野外可以救助，是怎么救助的？	哥们买小屋保险,说字段可以拯救,是如何帮助?
HUTS保险在野外提供什么救助？	小屋保险提供救济在野外吗?
百年康惠保保险在等待期有什么保障责任？	一百年康汇宝保险在等待期间有什么责任?
请问下HUTS保险在伤员转运方面是怎么做的？	受伤的小屋运输会怎么做?
慧择的huts保险有除了紧急救援之外，有没有其他特点？	明智的选择小屋保险除了紧急救援,还有其他功能吗?
打算利用假期进行环海南岛骑行，有相关保险推荐吗？	计划使用在海南岛度假骑环,有关保险的建议吗?
想知道，huts保险是有专门的救援队伍吗？	想知道,小屋保险是一家专业救援队伍吗?
请问下，一般重疾险里面会有哪些轻症也是可以保障的？	对不起,一般重疾病风险内部温和也可以保证什么?
我女儿未成年能投保哆啦A保吗	我的女儿是一个小可以确保哆啦A保
打算给老公投保一份重疾险，请问买什么好	要覆盖的风险为丈夫和买什么严重的疾病,请
huts保险如何进行野外搜救的?	如何实施现场救援小屋保险吗?
想请问下，安*长*树的受益人是固定的吗？	想秋天对不起,安* *树的受益人是固定的吗?
打算进行半年的境外游玩，huts保险中有合适的介绍吗	打算在国外访问半年,介绍小屋保险的权利
请问下买的huts保险，在什么情况下会展开救援？	请购买保险的棚屋,在什么情况下救援吗?
户外探险前买了huts保险，迷路了可以申请救援吗	前买小屋保险户外探险,失去了可以申请救济
想请问下,HUTS保险是哪家公司的,怎么样	想请问,小屋保险公司,
在国外陌生的地方，huts提供出行方面的指导吗？	在国外陌生的地方,小屋上提供指导旅行吗?
请问下，朋友说的huts旅游保险可靠不？贵不贵	对不起,朋友说旅游保险的小屋是不可靠吗?
家里有社保，还可不可以买康惠保保险？	家里有一个社会保障,也可以买康汇宝保险吗?
想知道康惠保对投保人的职业有没有限制？我是个老师	想知道康汇宝限制投保人职业?
周末和老公自驾游，可以投huts的什么保险？	周末旅行与我的丈夫,能把小屋的保险?
半年前生病已经有了安*长*树的理赔,以后还能赔吗	六个生病已经* *树称,安在未来可以补偿
想请问下公司组织团体活动，可以申请huts保险救援吗？	想问公司组织活动,可以申请小屋保险救济吗?
HUTS保险在国外管不管用，有什么特色的地方	小屋在国外保险管,有什么特点
慧择huts保险对户外运动方面保不保呢	回族选择户外运动的小屋保险保险没有证实
请问，我合肥的朋友买了康惠保，我在北*，也可以买吗	对不起,我的朋友买了康汇宝合肥,我在北*,也可以买到
不晓得慧择huts保险里面有没有费用垫付的？不够钱怎么办	不知道回族选择小屋保险已付费用吗?
huts保险救援和一般的救援想比，有什么区别或者优势？	小屋比保险救济和一般救济,或优势之间的区别是什么?
我女儿10岁可以投保康惠保吗？	我女儿十岁可以投保Kang汇宝吗?
请问下当前市场上有没有比较好的重疾险，麻烦介绍几种适合30岁的	有好严重的疾病在当前市场风险,麻烦介绍几种30岁吗
想请问下，我爸爸40多了，有没有保终身的重疾险？	想请问,我的父亲40多个,大病保险的一生吗?
有没有比较好的消费型重疾险介绍	消费者严重疾病风险有更好的介绍吗
请问，之前买过保险退保了，现在还可以买重疾险吗	对不起,之前买保险投降,现在还可以买重的疾病风险
请问下，重疾险可以买终身的吗	对不起,一个沉重的疾病风险可以买到生命
邻居叔叔有冠心病,还可以购买康惠保保险吗	邻居叔叔有冠心病(CHD),也可以买康汇宝保险
重疾险和年金险的区别	重大疾病保险和年金保险的区别
请问下慧择的哪些产品有HUTS保险服务	回族,请选择产品有小屋保险服务
huts是哪家出的保险产品,之前怎么没听说过	小屋的保险产品,以前从未听说过吗
不知道，huts保险提供的是什么类型的救援？	我不知道,小屋提供什么类型的保险救济吗?
想知道，慧择的huts保险对出国留学有保障吗？	想知道,回族选择保险的小屋去国外学习?
慧择的huts旅游险都有些什么？可靠吗	小屋旅行风险的明智的选择?
重疾险对比，哪款最好	重大疾病保险,这是最好的模型
慧择的HUTS保险只是保国内的吗？	回族选择小屋只是保护国内保险吗?
想要和闺蜜一起去西*玩，推荐个旅游险吧	想西*和女朋友一起玩,推荐一个旅游保险
安*长青树重疾险是不是只有大人可以买，我女儿10岁可以投吗	安*重疾病风险是他们唯一的成年人可以买,我女儿十岁可以扔
重疾险康惠保后期如何缴费？	多重疾病风险Kang汇宝逾期付款吗?
出国留学，huts保险有什么保险可以保障？	出国留学,小屋保险保险能保证吗?
今年已经投保了健康险，还有必要买重疾险吗？	今年投保医疗保险,需要买重疾病风险吗?
请问下，huts有哪些救援方式？	对不起,小屋救济方式是什么?
HUTS保险是哪家公司推出的，可不可靠	小屋公司,保险是不可靠的
投保哆啦A保之前需要进行体检吗？	保险哆啦A证实前需要体检吗?
想请问，什么重疾险比较实惠还可靠	想问什么,大病保险更便宜和可靠吗
请问下安邦长青树保险要不要体检的？	你想做生意在常绿保险检查吗?
百年康惠保对购买者的职业有要求吗？	一百年康汇宝职业要求买家吗?
自驾游,可以选购huts保险中的哪种呢?	路,选购保险的小屋是怎样的?
请问下，我能为闺蜜买康惠保保险吗？	对不起,我可以购买女友康汇宝保险吗?
请问下，安邦长青树是什么类型的保险？	对不起,他们是什么类型的保险业务?
我想知道重疾险是不是赔小病呢？	我想知道是否重疾病风险补偿疾病吗?
huts中，什么情况下可以申请直升机救援？	小屋,在什么情况下可以申请直升飞机救援?
具备huts服务，请问怎么联系救援？	小屋的服务,我如何联系救援?
在沙漠迷失方向，怎么申请huts无人区卫星定位？	迷失在沙漠和如何申请小屋无人区卫星定位吗?
huts为什么说是能救命的保险？	可以帮助保险小屋,为什么这么说呢?
申请了huts服务，请问紧急情况自己钱不够怎么办？	应用小屋服务,紧急,请不要自己有足够的钱做什么?
huts提不提供出行指导？	没有提供旅游指南的小屋?
有没有为户外运动人员提供第一现场救援的保险？	对于户外运动人员提供救援的第一个保险?
huts紧急救援只是国外有吗,国内的行不行?	小屋有任何紧急是国外的,国内的行不行?
我想知道，是不是重疾险保障的疾病都是一样的？	我想知道,如果重疾病风险保障疾病是相同的吗?
huts保险，有什么优势可以帮到投保者？	小屋保险,有优势,帮助客户吗?
想问下，慧择的那个HUTS有什么用处？	想问下,选择小屋有什么用?
在沙漠遇到危险，HUTS有什么办法帮助？	在沙漠和危险的小屋有一种帮助吗?
紧急救援为什么分第一救援和第二救援？	急救和第二次救援应急为什么点?
huts如果发生紧急情况，没有钱怎么办？	小屋在紧急事件,没有钱吗?
请问下，huts提供直升机救援是真的吗?	对不起,小屋提供直升飞机救援是真的吗?
多大年龄开始购买重疾险比较好？	什么年龄开始购买重疾病风险比较好?
境外旅游需注意：国外旅游保险哪个好	海外旅行注意:外国旅行保险好
只想知道,康惠保可不可靠,值不值得给妈妈买?	只是想知道,康汇宝并不可靠,值得买的妈妈吗?
最近听说了旅游保险中的HUTS紧急救援，有什么作用？	最近听说旅游保险应急救援的小屋,有什么影响?
打算去泰*玩一周，买什么旅游险有紧急救助？	去泰国玩一个星期,买什么旅行和紧急救援的风险吗?
准备去日*看樱花，老婆买了乐游全球可以有紧急援助吗？	准备一个忘记*看到樱花,妻子买了乐之旅可以全球紧急援助?
想问下之前买过重疾险还可以接着投保康惠保吗？	想问下之前购买重大疾病风险可以康汇宝吗?
我哥哥蹦极买了意外险，还可以购买安邦长青树保险吗？	我买了一个受害者的弟弟蹦极,还与常绿可以买保险吗?
去户外玩，买什么样的保险有紧急救助	保险要到外面玩,买应急救援
HUTS紧急救援保险是什么意思？	小屋紧急保险的意义是什么?
老公喜欢跳伞怎么办，用什么保险可靠？	丈夫喜欢跳,什么样的保险是可靠的吗?
重疾险的理赔快不快，麻烦吗？	重大疾病保险索赔快不快乐,麻烦吗?
安*长*树怎么交后续的续期保费呢	安* *树如何支付后续的续保保险费
旅游保险有哪些险种，投保旅游险的方式有哪些	什么是旅游保险险种,旅游风险是什么
健康险哪种最好主险和附加险有啥关系	最好的医疗保险,主险和附加险有什么关系
huts旅游保险价格怎么样	小屋的旅行保险价格
打算去爬黄*，什么样的运动险便宜实惠？	要爬上黄色,什么样的体育风险更便宜?
哆啦A保会提供什么类型的发票?有了解的亲吗	哆啦A调酒师将提供什么样的发票?
是不是康惠保小孩子只能自己的父母买啊？做舅舅的也不可以？	不是康汇宝孩子买他们的父母?
为什么要买重疾险	为什么买重疾病风险吗
华夏福康惠保哪个好	华夏Kang汇宝哪个好
提前咨询高风险运动保险哪家好，让	提前咨询高危体育保险是好的,让
哆啦A保在线核保有什么好处？被拒绝怎么办	网上多拉承销保险有什么好处?
发小组织去户外拓展，我们总共5个人买什么保险可靠？	小型组织户外拓展,我们一共有5个人购买保险和可靠吗?
户外运动保险和普通旅游险对比有哪些不同	户外运动风险保险和普通旅行相比有什么不同
这个是重疾不，买了重疾保险可以理赔不	这是一个严重的疾病,可以没有严重的疾病保险索赔
安*长*树在理赔方面有什么特点？	安* *树的索赔有什么特点?
公司准备办春季运动会，什么运动险实惠？	春天准备做什么运动运动,保险金吗?
最近看到huts救援，是什么意思？谁知道？	最近看到了小屋,是什么意思?
美*的医疗费特别贵，这次去纽约玩买什么保险可以保这方面？	美*医疗特别贵,这次去纽约玩这方面购买保险可以保护什么?
和闺蜜一起去美*游玩，银行卡不小心被盗刷，这个乐游全球保吗？	对美国的访问与女友*,银行卡被盗刷,不小心勒游泳全球保修吗?
能不能给未成年的儿子买哆啦A保？	你能买的儿子小哆啦A保?
想问下,我妈妈今年50,还能买康惠保吗	想问下,今年50岁,我母亲也可以买康汇宝
五一我们一家人都去美*玩，家里没人乐游全球保险会保障家庭财产吗	五一我的家人去玩,家里没有人快乐游全球保险保障家庭财产吗
投了一份2.2元的众行天下，如果发生意外可以赔付多少钱？	把世界的2.2元,如果事故能赔偿多少钱?
长青树保险的犹豫期相对而言长不长	常绿保险犹豫期相对较长
想知道,和5岁儿子一起户外拓展,儿子也可以购买众行天下-拓展训练保险吗?	想知道,户外发展和5岁的儿子,儿子也可以买到全世界——培训保险吗?
弘康哆啦A保对疾病的保障责任是什么？	香港康哆啦A保修担保责任的疾病是什么?
百年康惠保保险的缴费年限长不长？	一百年康汇宝保险缴费年限很长时间吗?
本周末准备带孩子去郊游，想买一份合适的保险推荐下。	这个周末去郊游要带孩子,建议想购买合适的保险。
想请问下，乐游全球旅游险有没有紧急救援保障，我们要去登雪山	想秋天对不起,欢乐全球旅行保险你有什么应急保障,我们将去爬山
近期计划投保康惠保，这类产品提供什么类型的发票呢？	最近计划以确保康汇宝,这种产品提供什么样的发票?
百年康惠保保险为什么有等待期？	一百为什么康汇宝保险有等待期吗?
安*长青树保险小病是怎么赔付的？	安*保险他们的疾病是如何支付?
众行天下只能是登山之类的运动吗，想要潜水可不可以买	全世界只有登山运动,可以想潜水买
安*长青树出险理赔，对医院有没有要求？	安*事故索赔,他们的要求去医院吗?
安*长*树的保额够用吗？多不多？	安* *树足够的报道吗?
乐游全球的高风险意外伤害身故包括哪些运动？	Le旅游意外伤害死亡的全球风险包括什么运动吗?
这周和兄弟一起登山，买了众行天下还要买意外险吗？	本周和你的兄弟一起登山,买了世界也想买保险吗?
去美*之前投保了乐游全球，想问下自驾车意外伤害可以赔付多少？	去美*确保之前的音乐世界,想问下租的意外伤害可以支付吗?
百年人寿康惠保可以保障终身吗？	一百年康汇宝能保证生活?
和闺蜜投保乐游全球去日*玩，还要备一份意外伤害险吗？	和女朋友快乐游泳时间*世界各地玩,准备一个意外伤害保险吗?
我想知道，众行天下保费高不高，想进行为期一个月的野外拓展运动	我想知道世界和成本不高,想了一个月,户外运动
近期打算去玩漂流，买什么产品保障比较好？	最近打算去玩,买什么产品安全是更好吗?
乐游全球中的行程延误大概可以理赔多少钱？	勒参观全球旅行延误可能理赔多少钱?
去泰*游玩，打算入手乐游全球保险，合适吗	访问泰国*全球保险计划
我舅舅长期抽烟，请问安邦长青树是不是不给买？	我叔叔吸烟很长一段时间,你能告诉我这不是买常青?
春节和老婆去南方旅游，有水上活动安排，买什么保险比较适合呢？	春节和妻子前往韩国,有水的活动安排,购买保险来满足什么?
陪女朋友去佛*伦*半个月，投保乐游全球费用高不高？	陪我的女朋友去* *半个月,并确保全球le旅游费用高不高?
想问下儿子儿媳去巴*度蜜月，给投了乐游全球，15天管用吗？	想问下儿子儿媳*蜜月,把音乐世界,15天的工作吗?
去泰*途中证件丢失了，旅行团说乐游全球保险可以赔，是真的吗？	飞往泰国*证书丢失,旅游说快乐全球保险可以补偿,这是真的吗?
当下有没有适合的自行车运动保险产品？	现在你有什么适合自行车保险产品吗?
我想问下,康惠保的保额是多少,多不多?	我想问下,康汇宝覆盖率是多少,多少钱?
下周公司有个足球友谊赛，有没有专门针对这类运动保障的保险产品？	下周,该公司有一个足球比赛,有什么保证保险产品专门为这种运动吗?
男朋友报名参加了冬季马拉松，想给他买份保险买什么呢？	冬天的男朋友,报名参加马拉松,想买什么给他买保险?
我准备周末去骑马，第一次，想问下买什么保险保障好？	我准备周末去骑马,第一次,想问下买什么保险?
女朋友特别喜欢玩极限运动，还去蹦极，买什么保险有保障？	女朋友喜欢玩极限运动,但也去蹦极,购买保险保证什么?
要和哥哥去美*玩，两个人15天乐游全球要保费多少？	和弟弟玩在美丽的*,两个人游泳15天乐溢价世界?
和闺蜜投保完乐游全球组团去日*大*，现在我的证件丢了怎么理赔，急！	和覆盖的女朋友游泳时间* *的跨国集团,现在我失去了我的文档如何索赔,急!
我是个自由职业者能投保康惠保吗？	我是一个自由职业者可以确保康汇宝吗?
乐游全球保险管不管行李*失？	全球保险管不管行李遗失*勒吗?
想知道，安*长*树的犹豫期是多长时间？退保是不是要扣费？	想知道,安* *树的犹豫期是多久?
大家都上玻璃破碎险了吗	所有的玻璃破碎险
哆啦A保可以专门针对轻症理赔吗？	多拉温和的赔偿可以保护吗?
找一款有紧急救援的保险，准备寒假去攀冰。	寻找一个紧急保险,准备攀冰的寒假。
安*长青树重疾险是不是只能保障重大疾病,小病可以报销吗?	安*重疾病风险仅仅是保证他们的重大疾病,疾病可以报销吗?
已经有了乐游全球保险去韩*玩，却不想途中遇到交通事故，这种情况旅游险可以赔吗？	勒*全球保险到韩国玩,但不想是一个交通事故,这种情况可以弥补旅游政策?
我比较喜欢户外运动，经常攀岩潜水，什么保险能保这些?	我喜欢户外活动,经常爬潜水,保持这些保险吗?
没有重疾保险，怎么敢生病	怎么敢不严重的疾病保险,生病了吗
去捷克游玩之前老婆买了乐游全球保险，现在行李丢了，可以报销吗？	之前我去参观捷克的妻子买欢乐全球保险,现在丢失的行李,可以报销吗?
老公给我买了乐游全球去法*，可以我已经有意外险了，重复了吗？	丈夫给我买了一个游泳的全球法律*,我可以有伤亡,重复?
我要给我妈妈买康惠保重疾险，我妈妈40了，还能买吗？	我想给我妈妈买康威医疗疾病的风险,我母亲是40岁的也可以买吗?
过年想要去三*冲浪，有什么运动保险可以保障？	想去冲浪在三*新年,体育保险能保证什么?
参加公司举办的冬季马拉松，给投了众行天下，这个保障吗？	参加公司举办的冬季马拉松,在所有的世界,这种保证?
老婆想要重疾险康惠保，之前她做过手术，怎么知道她能不你那个买？	妻子希望康汇宝大病保险,之前她手术,你怎么知道她不是你可以买吗?
现在的康惠保，还需要交现金吗？不是很麻烦？	现在康汇宝,还需要支付现金?
准备和兄弟一起去攀岩，有没有攀岩险？	准备和哥哥去爬山,攀岩风险?
第二年保险，有必要买划痕险和玻璃险吗	第二年的保险,需要购买玻璃划痕和风险
和男朋友乘坐游轮，包包丢失了，投保的乐游全球能不能赔？	丢失,克鲁斯与现任男友、袋覆盖全球可以补偿le旅游吗?
老公买乐游全球去美*,家里没人,对家里财产有保障吗?	丈夫买游泳世界美丽,没有人在家里,房产有保障吗?
和闺蜜打算去日*富士山，待个15天，有什么旅游险可以保？	和女朋友要忘记*富士山,等待15天,旅行风险可以被证实是什么?
想知道，安*长*树究竟对重症能赔多少钱？	想知道,安* *树木密集可以赔偿多少钱?
小姑子特别喜欢去韩*玩，说乐游全球可以保障旅途中很多意外，是真的吗？	XiaoGuZi特别喜欢去韩国*,全球旅行快乐说能保证很多惊喜,是真的吗?
康惠保保险的犹豫期10天内退款，是不是不扣费？	犹豫Kang汇宝保险退款10天内,旅游费用吗?
去古*旅游要买保险吗	参观古老的*购买保险
春节去冰岛看看，请问下老婆买的乐游全球可不可靠？	春节到冰岛去看,你能告诉我妻子买了乐旅游在全球不可靠吗?
我二婶生病报过社保了，和她的安*长*树充不冲突	我有相同波长生病在社会保障、和她的* *树不冲突
我准备去夏*夷潜水，请问需要做什么样的准备以及买什么保险好？	我准备他们的防御* ee潜水,你能告诉我什么样的准备需要做和买什么保险?
和女朋友约好过年去境外走走，投保了乐游全球这款保险包意外吗？	好元旦和他的女朋友一起去外面散步,保证快乐的游泳世界这种意外保险计划吗?
我老婆买了去日*的机票，她还买了乐游全球，说闺蜜推荐的，好不好？	我的妻子买了一个忘记*票,她还买了音乐世界,说最好的朋友推荐,好吗?
我老妈最近总吵着要给我买份重疾保险，怎么办	我妈妈最近总是问给我买重大疾病保险,如何去做
康惠保重疾险投保有什么原则，是不是小学生不能投？	康威关心疾病风险保险原则,学生不能把?
老*今年47了，买安邦长青树保险还给投保吗？	老* 47岁,购买商业保险来弥补?
百年人寿不是做寿险的吗，康惠保这重疾险能行得通？	生活不是要做,一百年康汇宝这个沉重的疾病风险可以吗?
快春节了,想要去巴*玩,买意外险好还是旅游险可靠?	元旦快了,想去玩,买保险好或旅行保险可靠吗?
打算参加今年的马拉松比赛，现在在锻炼，问下平时长跑有保险吗？	将参加今年的马拉松,在锻炼,现在问下运行平时有保险吗?
老婆买安邦长青树保险花了不少的钱，有没有用？	妻子买商业保险花了很多钱,他们没有?
想要一款既可以保障重疾而且小毛病也保障的健康保险，哪个靠谱？	想要一个可以支持重疾病和弱点也支持医疗保险,这靠谱吗?
我哥买了哆啦A保，怎么没有看到拿保单回来？	我的哥哥买了一个哆啦A保,没有看到如何采取政策回来?
安邦的保险那么多,又有长青树啥的,保障些啥?	保险业务,和常绿,维护的一些什么?
和闺蜜约了一起去纽约玩，个人出行要买保险不？	和女朋友去纽约玩,个人旅游保险不买吗?
老公都已经有社保了，那还有必要买重疾险吗？	丈夫已经有了社保,有必要买重疾病风险吗?
老公喜欢攀岩，但是我很担心这种运动，很危险？	丈夫喜欢攀岩,但是我担心运动,是很危险的吗? ? ? ? ?
安*长青树是不是只能赔付一种小病？	安只能支付少量*常青?
打算趁着假日去日*游学一段时间，这段时间应该买旅游险还是意外险？	计划在假期时间去旅游一段时间,这段时间应该买旅游保险或意外保险?
儿子儿媳春节去美*度假，给他们报旅行团有保险没有？	儿子儿媳*春节去度假,没有任何他们的旅游保险报价?
公司给我买了社保，是不是报销了，重疾保险就不能报了？	公司给我买社保,报销,重大疾病保险不能报价吗?
周末约了女朋友一起去露营，有没有比较实惠点的保险保障？	周末和女朋友去露营,有没有保险更能负担得起吗?
我想要学滑翔伞，这个危险系数大不大？有什么保险可以保障？	我想学飞,危险系数大吗?
春节快到了，准备和老婆去美*度假，需要买什么保险才好？	春节快到了,准备和妻子去度假*,什么需要买保险。
为什么保险有等待期？安邦长青树的等待期是多久？	为什么会有等待期保险吗?
明年给我女儿申请日*留学，保险买什么比较好？	申请*旁边我女儿学习,更好的购买保险是什么?
我负责公司组织的冬季马拉松比赛，200个同事要买什么保险才更好？	我负责公司的组织冬季马拉松,200的同事更好的购买保险是什么?
本人28，刚有个宝宝，想要给老公买重疾险，有什么推荐的？	我28岁,生了一个孩子,要给她的丈夫买重大疾病保险,有什么建议吗?
小***病用社保报销了，他同时买了哆啦A保，可以理赔吗？	小* * *病使用社会保障费用,他买了一个哆啦A保在同一时间,你可以索赔?
机动车玻璃划痕险什么意思？	汽车玻璃划伤的风险你是什么意思?
看见安邦长青树中的犹豫期，是什么意思？	看到他们的犹豫期,是什么意思?
车损险有必要买吗车损险应该怎样买划算	报道必须购买保险应该如何购买便宜
安邦长青树保险是不是买了就不能退了？	导致他们与常绿保险不能买回来?
我老公是德*人,我是中*人,我们都想要买康惠保有优惠吗?	我丈夫是德* *我,我们都想买康威有折扣吗?
最近听说平安一款比较有意思的产品,乐游全球,这个保障什么?	最近听到一个更有趣的产品安全、快乐全球,这保证吗?
怎么知道自己是否成功投保了安*长青树重疾险啊？	你怎么知道他们是否成功安*常绿重病封面吗?
本人30岁了，想买款时间比较久的重疾险，看到了康惠保，合适不？	我30岁,要争取时间长了重大疾病保险,看到康汇宝,对吧?
弘康哆啦A保的缴费年限是多久？	香港康哆啦A保缴费年限是多久?
哆啦A保重大疾病理赔后身故，还给身故保险金吗？	哆啦A重大疾病保险索赔后死亡,死亡保险吗?
我小侄女才5岁，很可爱，可以买康惠保重疾险吗？	我的侄女只有5岁,非常可爱,可以买康威医疗疾病的风险?
前段时间入保了康惠保，这几天想要退，退保流程是怎么样的？	最近,取消Kang汇宝,想返回这些天,流程是什么?
买保险，发现安邦长青树有犹豫期，这个是什么意思？是可以退保费吗？	购买保险,发现这是他们的犹豫期,这是什么意思?
买了哆啦A保，如果没有得疾病，自然死亡是否赔钱？	买了一个哆啦A保,如果没有疾病,亏钱是自然死亡?
老公的康.惠.保重疾.险需要理赔，要准备什么材料啊？	康回族的丈夫。
您好,为什么康惠保没有纸质的保单,这个有没有法律效力?	你好,为什么没有康汇宝纸的政策、法律效力?
安*长青树续保费是不是得去保险公司才行？	安*常绿树木去保险公司更新保险费?
百年人寿康惠保的缴费年限是多久？	生命有多长康汇宝缴费年限一百年?
弘康的哆啦a保险最高续保到多少岁？	香港康哆啦a最高同意多大?
新车到底要不要买划痕险	新车真的想去划痕
老公的康惠保重疾险需要理赔，要准备什么材料啊？	丈夫康威医疗疾病风险需要调整,准备什么材料?
买了安邦长青树，不晓得里面的轻症赔付是什么意思？	买了常绿,不知道里面的温和的声明是什么意思?
我女儿才10岁，能不能买哆啦a保终身的？	我的女儿只有十岁,你能买一个哆啦一辈子吗?
现在都喜欢在线支付了，安*长*树也可以在线支付吗?	像在线支付现在,安* *树也可以在线支付吗?
哆啦A保本投保提供什么类型的发票?	哆啦A保本确保提供什么样的发票?
康惠保保险的保额高不高？	康汇宝保险金额,高不高?
我今年才20，哆啦a保险最高续保到多少岁？	我今年20岁,哆啦a最高同意多大?
买了寿险还需要意外险吗	买的生活也需要伤亡
看到慧择网的哆啦A保，这个是可以多次赔付的嘛？	看到回族选择网络哆啦A保,这可以多次支付吗?
之前康惠保理赔过一次轻症，那么万一有什么重大的疾病，保额会变少吗？	康汇宝索赔之前温和,那么什么是重大疾病,一千年报道将会不会少些?
想问下，买了安*常*树是不是只要赔一次就不给赔了？	想问下,买了安*总是*树不是只要补偿不会给丢了?
安*长青树那个职业怎么选，我为女儿买的她才8岁？	安*,他们的职业生涯如何选择,我就给她买了女儿,她只有八岁吗?
社会保险，公司	社会保险,公司
进口玻璃险需要买吗	进口玻璃需要购买的风险
生育保险想受不了的怎么办	生育保险受不了
常青树保险投保时未成年人怎么选职业?	常青树时选择专业保险保护未成年人?
了解意外险理赔的条件有哪些	保险索赔的条件是什么
买了份安邦的重疾险长青树，怎么查自己的保单啊？	买了一份沉重的疾病风险常绿,如何检查你的保险政策?
安*常*树如何交后续的续期保费?	安*总是*树如何手在随后的续保保险费吗?
哆啦A保出险报案时需要注意什么	哆啦A保或摆脱危险的报表时需要注意
团体意外险的赔付实效	团体保险补偿效应
可走玻璃险吗，能赔多少钱	可以走一个玻璃风险,可以补偿多少钱
没有结婚证，只有准生证可以报销生育险吗	没有结婚证书,只有ZhunShengZheng报销生育风险
哆啦A保理赔的时候，提供什么账号保险公司赔偿得更快？	哆啦A保修索赔,账户保险快吗?
买有玻璃险，不知道换前挡玻璃要多少钱	买一个玻璃,不知道前面的玻璃多少钱
车辆超载酿事故保险公司要赔偿吗	重载车辆事故保险公司赔偿
交通事故保险公司会不会出现少赔的情况对于伤者	交通事故保险公司不会受伤,失去更少
车辆出险向保险公司索赔需提供哪些单证	什么是需要提供车辆或摆脱危险向保险公司索赔文件
航空意外险哪些能理赔	航空事故索赔
私家车三责险价格	三个主要的风险价格的私家车
有哪位报过玻璃险的	玻璃已经引用的风险
高速拖车费2000元保险公司给报吗发票收据都有	高速公路运输费用2000美元保险公司给的收据发票
现在出现交通事故！受害人可以相信保险公司吗？对相应的赔偿	有交通事故!
宝马x5要不要办玻璃险	宝马x5,你愿意做玻璃
汽车划痕险有必要买吗汽车玻璃险保险范围/价格	车刮伤的风险,有必要买一辆车玻璃覆盖/价格
车辆遇险不涉及人伤的处理，怎样避免车险理赔	车辆遇险不涉及使用的方法和人打交道,如何避免汽车保险索赔
交强险过期5个月晚交会罚款吗	保险到期五个月后委员会罚款
重疾险病种越多越好吗	重疾病患病的风险越多越好
购买延误险需要哪些小技巧	买小延迟风险所需要的技能
家庭财产保险怎么分类有哪些种类	如何分类什么样家庭财产保险吗
我的前挡风玻璃坏了有没有必要买个玻璃险	我的前挡风玻璃破碎的如果有需要买一个玻璃
相撞，他负全责我腿部骨折保险公司理赔，能赔多少钱	碰撞,他负全部责任我的腿断了,保险公司赔偿,可以补偿多少钱
现在的小孩子买什么保险好	现在孩子们购买保险
强制保险标志咋样辨别是那家保险公司的	强制保险是保险公司如何确定
车保险全保有那些	所有的汽车保险
意外险保的是什么?大家有清楚的吗?	在伤亡保险是什么?
大车三者险怎样买便宜	如何购买廉价车三个风险
商业险第二年都买什么险	第二年业务风险的购买风险
未买玻璃险，如何走保险	不买玻璃险,保险怎么走吗
去哪家公司比较好最新儿童保险公司排	哪个公司是更好的儿童保险公司的最新行
大家一般都买哪些商业险	人们通常购买什么类型的业务风险
又来求解答啦，新车需要买玻璃险和划痕险吗	再次找到答案,需要买一辆新汽车玻璃和刮伤的风险
车辆保险过期，被交警查，交多少罚款	交通警察检查的车辆保险到期,并支付罚款
如何购买车辆交强险	如何购买车辆保险吗
奥迪玻璃险买4S店的吗	奥迪玻璃风险购买4 s店
车还有必要买车损险吗	和需要购买汽车保险
意外受伤，要报保险，伤残怎么鉴定	报保险,伤害和残疾鉴定
时还要对方保险公司来评估定损吗	当保险公司相互评价
买自燃险和附加设备险吗	买一个自燃风险和额外的设备
交通事故人伤司机先行垫付医药费保险公司给承担吗	交通事故受伤领导司机支付医疗保险公司承担
摔伤意外险	伤害事故
工程一切险包含范围	工程一切险包括的范围
车被墙刮了，可以报保险吗	车被刮墙,可以报保险
借别人生份证交生育金能申领吗	借一个人出生的证券交易委员会(sec)生育黄金可以声称
飞机延误险有必要买吗飞机延误全额退款吗	飞机延迟风险必要买一架飞机延迟全额退款,谢谢
现在已经两个月没有交了，我要不要自己去社保局补交	现在还没有支付两个月,我要去社保局不填
今天早上骑电瓶车碰到别人车屁股，后保险杠被撞坏，保险公司会有赔偿吗	屁股,蓄电池遇到其他骑自行车人今天早上在保险杠受损,保险公司必须赔偿
面包车坐垫拆出车祸保险公司赔不赔	范缓冲事故保险公司赔不赔
关于保险的问题求助下	关于保险的问题寻求帮助
保险和年检是一起的吗	保险和年检在一起
什么情况下保险人按全部损失赔偿	什么情况下保险人按照全损索赔
保险公司，“醉驾入刑”对保险合同履行有怎样的影响	保险公司,“酒后驾车处罚”什么样的保险合同的影响
飞机托运要钱吗航空意外险保平安	它将成本在航空飞机检查伤亡保险的和平吗
汽车保了不计免赔出了事责任在自已要拿钱赔吗	特许经营的汽车保险不管责任在他们拿钱
一般大家的摩托车会去买保险还有年审吗	通常摩托车会买保险和年审
每月的哪天去保险公司交意外伤害保险	每个月的哪一天向保险公司支付伤害保险吗
玻璃划痕险有必要买吗	玻璃划痕险有必要买
为什么买机票但不能买保险呢第7页	为什么买机票但不能买保险第7页
刚看了某保险公司意外险的，适用条款，我理解的对么	刚刚看到一个伤亡保险公司,适用的条款,我明白了
求助：后保险杠被撞保险公司能全赔吗	保险杠碰撞保险公司寻求帮助:可以完全补偿
保险那些事，重疾保险到底应不应该买，重疾保险哪种好	什么保险、重大疾病保险应该买重大疾病保险,真的很好
瑞虎7车险一年交多少钱，瑞虎7车险一年多少，瑞	Tiggo或丁格尔7汽车保险支付一年多少钱,Tiggo或丁格尔7多少一年,汽车保险
只有交强险，撞人了保险公司只赔1万吗，超出的	只支付保险,保险公司赔偿10000,
保险公司不会理赔，是真的吗	保险公司不会声称,这是真的
开车蹭到了树保险公司给理赔吗	开车到树要求保险公司
车开沟里保险公司陪钱吗	汽车明沟保险公司
汽车保险怎么买划算精打细算买车险	如何购买汽车保险费用计算在汽车保险吗
汽车划痕险和玻璃险到底买不买	汽车玻璃划痕和风险是否买它
日*留学必须买健康保险吗	天*留学必须购买医疗保险
农村住房被火烧,保险公司最高要赔偿多少钱?	火,农村住房和最高的保险公司会赔偿多少钱?
交保险.公司每年会体检吗	支付保险。
房车买保险，各省市，各保险公司的标准一致吗	轿车购买保险,每个省份和城市,每个保险公司的标准一致
车险定损后会查骗保吗	汽车保险费用后将检查保险欺诈吗
留学生保险	国际学生保险
我提交了所以资料，为什么人寿保险公司的	我提交,人寿保险公司的原因
有了社保要不要追加商业医保	你想要额外的商业保险的社会保障吗
大家买的车险都多少钱	你买了汽车保险多少钱
去请问一下这样保险公司会把钱直接打给我	保险公司会对不起,钱直接给我打电话
汽车玻璃险的赔偿范围以及不赔情况是怎样的	汽车玻璃情况风险补偿范围和补偿什么
车子撞了，可以在外面修理厂维修吗，这样保险公司给	被车撞,可以维修店修理,这个保险公司之外
冰雹把车砸了，保险公司给赔吗	冰雹砸车,保险公司赔偿
光买三者险可以吗	买三个风险
发生事故保险公司为什么不赔我	事故保险公司为什么不你失去我
现在买车险哪家保险公司优惠大些	现在汽车保险,保险公司提供
在外春游，谈谈境外旅游保险怎么买	春游,谈论如何购买海外旅行保险
农村交小额意外保险报哪些费用	农村小事故保险报价
意外疾病终身保险买哪种好	意外疾病人寿保险购买什么样的好
开到水里全部被水淹了保险公司怎么赔	打开所有的水淹没了保险公司如何补偿
农村户口买社保划算吗	为农村住宅购买社保
强制险可以脱险多久	是强制保险可以逃避多久
给农村老人买什么养老保险	购买农村老年人养老保险
打成这样可以出玻璃险吗	玻璃这种风险吗
过年儿子就12岁了，还可以买少儿健康险吗？	庆祝儿子12岁,还可以买儿童健康保险吗?
全景天窗贴不贴膜，买不买玻璃险	全景天窗贴贴纸,买不买玻璃的风险
保险公司给自己的员工上什么保险?	保险公司为员工上保险吗?
我想问我买了保险，受益人没有指定，一般是父母，妻子，子女，这里的父母值得是我的父母，包括岳父岳母吗	我想问我买了保险,未指定受益人,通常父母,妻子,孩子,父母在这里值得是我的父母,包括我的岳父
现在的车损险还有必要么	覆盖和必要了
交强险和三责险，不买车损险可以吗	保险和三个主要风险,不能购买保险
投保人有什么权利和义务	申请人的权利和义务是什么
现在的年轻人交社保有意义么，保险会考虑么	年轻人现在支付社会保障意识,保险将考虑它
想改自己买一份健康险，没那个好呢。今年30岁，女	改变自己买健康保险,没有那么好。
满一年上保险，有几险	满一年保险,有几个风险
买了社保，是不是就不用买商业保险了？	买了社保,如果你没有买商业保险?
意外险和与工伤待遇有什么不同	有什么区别事故和工伤待遇
失业几个月了求帮助	失业数月的帮助
我在犹豫期内退保，真的能退成功吗	我犹豫了一项贷款,真的可以成功
现在10岁以下的小女孩买什么样的保险好？	现在10岁以下的小女孩买什么样的保险?
驾车过失致人死亡，交强险需要理赔吗	驾驶过失致人死亡,需要保险索赔
是不是保险买商业险百伍万才可以买的别的险	如果购买保险业务风险几百WuWanCai可以买其他风险
办居民医保麻烦不！需要些什么！之前一直没有办。	居民健康问题!
老婆快生小孩了,啥时候给孩子买健康险合适?	妻子快生了一个孩子,什么时候为孩子购买医疗保险?
两车相撞，两车都损失严重，我车上有一人受伤住院，双方都有保险，同等责任相撞互配这种情况下保险怎么弄	两辆车相撞,两辆车有严重的损失,一个人受伤在医院,我的车保险,双方平等的责任互相碰撞,在这种情况下如何获得保险
家政意外险是否有需求投保	如果有任何需求的国内伤亡保险
车子过了年检，保险公司会理赔吗	汽车年检后,保险公司会要求
惠*安保费贵不贵？一年需要多少钱？	安回族*溢价是昂贵的吗?
给上幼儿园的儿子买健康险，很贵吗？	买健康保险为幼儿园的儿子,很贵吗?
有必要给孩子买健康险吗？	有必要给孩子买医疗保险吗?
买健康险，什么样的标准最好？	购买医疗保险,什么样的标准是最好的?
慧*安与一般健康险比亮点是什么？	安回族*和一般健康突出是什么?
问下各位，给女宝宝买千元内的健康保险可以吗？	问下大家,给宝宝在一千元买到健康保险?
惠*安的理赔材料要准备什么？	安回族*准备索赔材料吗?
我想给女儿买健康险，但是爷爷反对，怎么办	我想买健康保险为他的女儿,但爷爷,如何去做
现在想要给儿子买健康险,需要注意什么	现在想为儿子购买医疗保险,需要注意
刚上幼儿园3岁女宝宝，买份重疾险，买种的好？	只买3岁女宝宝幼儿园,大病保险,MaiZhong好吗?
给孩子买保险，有保额高保费低的产品吗	为孩子购买保险,额头高溢价较低的产品
给7岁孩子买健康险可以在线投保免体检吗？	7岁的孩子可以买医疗保险在线免费体检吗?
儿子在学校买了学平险,再买重疾险冲突吗?	儿子买了一个平坦的风险,在学校买重疾病风险冲突?
家里女宝宝已经五岁了，想买一款重疾险不晓得哪个好	在家五岁女宝宝,想买一个严重疾病的风险不知道哪个好
给小孩子投保惠欣安保险划算吗	保险HuiXinAn小孩留给对方
儿子一岁多，最好保额达到五十万，买什么比较好	一岁多的儿子,五十万年,百思买是什么更好
慧心安理赔流程麻烦吗？	慧心安索赔过程麻烦?
给14岁女儿买少儿保险要考虑什么？	14岁的女儿买什么考虑孩子的保险吗?
小女儿上幼儿园，之前没有买过保险，买什么种类好呢？	在幼儿园,小女儿之前没有买保险,买什么?
我家宝宝是剖腹产的已经一岁了,买什么健康险合适	我的宝宝是剖腹产一年,购买医疗保险
我家女儿今年3岁买了意外险还需要买什么保险	我女儿今年3岁买保险需要买什么保险
今年生了二胎，刚满月，有什么保险适合这样的小孩子？	今年生了第二个孩子,只是一个满月,这个孩子的保险是什么?
女儿刚上初中，买了学平险还要买健康险吗？	女儿刚上初中,学习平风险也想买健康保险买了吗?
小孩子已经有社保了还有必要买商业健康险吗	孩子们已经有了社会保障和需要购买商业健康保险
在给小孩子买重疾险的时候主要看中哪些关键点	当给孩子买主要承担沉重的疾病风险的关键
来中*的外籍儿童可以投保慧馨安产品吗？	外国小孩可以投* BaoHuiXin安产品,好吗?
苦恼为孩子买健康险，求推荐一款	痛苦给你的孩子买医疗保险,请推荐一个
请问现在有那种保额高保费低的保险吗适合小孩子的	现在有一个高溢价低保险适用于儿童
市面上有适合小孩子又可以缓解家庭经济压力的保险产品吗？	有适合儿童和可以减轻家庭经济的压力保险产品?
给小孩子买保险担心保额不够高，保障不充足，有什么产品可以弥补这个缺点吗？	给孩子买保险担心不高,安全是不够的,产品你能做到什么?
月收入八千的给一岁孩子买健康险怎么买？	月收入八千美元买一个岁的孩子买医疗保险吗?
给少儿买重疾险，保额多少起步为好	购买儿童重大疾病保险,多少范围开始
现在有几百元就能买到的少儿健康险吗	现在有几百元可以买儿童健康保险
少儿重疾险花几百元的话能买到吗	儿童大病保险可以买花几百元
孕妈妈想给孩子买健康险，请问什么时候买合适？	怀孕的母亲对孩子想买健康保险,你能告诉我购买的好时机是什么时候?
有没有适合小朋友的重疾险投保	你有适合孩子的沉重的疾病风险保险吗
0-5岁的孩子现在买什么样的保险好	0到5岁的孩子现在买什么样的保险
现在的少儿险有什么保险保额是可以翻倍赔付的	现在孩子的风险与保险可以补偿的两倍
慧馨安投保费率差别大吗	汇鑫安保险费率差异大
投保慧馨安0岁男孩一年保费多少	演员BaoHuiXin安0岁的男孩一年多少溢价
慧*安现在在哪里能投保找谁?	现在安回族*保险在哪里可以找到谁?
慧馨安少儿险投保是不是男孩保费要便宜些	汇鑫安孩子是男孩保费便宜保险承保的风险
投保慧馨安少儿险保费跟性别也有关系吗	演员BaoHuiXin安儿童风险溢价与性别有关
给小孩子投保健康险那种不要体检保额高点的有吗	给孩子不高价值医疗保险医疗保险
现在慧馨安少儿险说的特定重疾保额是多少来着	汇鑫小危险说现在是多少某些严重疾病的报道
慧馨安少儿险等待期是多久	汇鑫小危险等待期长
慧馨安保险对身故是怎么赔偿的?	汇鑫保险赔偿死亡是什么?
慧*安这个保险有纸质保单吗	安回族*这种保险有纸的政策
最高可保120万的儿童重疾险,值得买么	可保风险最高的120万名儿童重病,值得购买
投保慧馨安这个保险是不是只有父母才能给买	演员BaoHuiXin安不仅仅是父母可以给买保险
家住合*在哪里可以去投保慧馨安少儿险	住在我们*我在哪里可以去投票BaoHuiXin安小危险吗
孩子目前还没有上幼儿园在老家，现在可以给小孩买份重疾险吗	幼儿园的孩子没有在我的家乡,现在购买可以给孩子一个沉重的疾病风险
我家孩子是剖腹产的，现在满两个月了想投保一份健康险有合适的吗	我的孩子是剖腹产,两个月现在有权确保医疗保险
慧馨安如果理赔过一次就不能再赔了吗	汇鑫安如果声称一旦你不能迷失
惠*安保费贵不贵？一年需要多少钱？	安回族*溢价是昂贵的吗?
慧*安是不是消费型的保险	安回族*是一个消费者的保险
我家孩子刚满一周岁，除了意外险之外，健康险可以怎么选择？	我的孩子一岁,除了伤亡,医疗保险可以如何选择?
小孩子多大开始可以买慧馨安这款保险	孩子多大开始可以买汇鑫安保险吗
据说慧*安对于特定重疾是双倍赔付，是真的吗？	安回族据说*特定疾病双重赔偿,这是真的吗?
慧*安*儿险对身故有赔偿吗	安回族* *的儿子任何补偿死亡的风险
给小孩子投保慧馨安少儿保险划算吗	演员BaoHuiXin安儿童保险负担得起的小孩子
儿子一岁多，保额打算二十万，买份消费型保险有没有好的	购买时间超过1年的儿子,二十万年,一个消费者保险你有什么好
那款凉皮机做出来的凉皮好卖吗	凉皮凉皮机使好卖
餐饮灯饰照明灯具,国内哪个牌子好?	餐厅灯光照明灯具,国内哪个牌子好?
新出的慧馨安少儿险有什么好的谁知道	新汇鑫安什么什么好谁知道危险
慧*安提供双倍保额给付的特定重疾具体是哪些种类？	安回族*提供具体的重量重复保险支付疾病具体什么样?
慧馨安投保有犹豫期吗	汇鑫安保险有犹豫期
惠心安少儿险是不是越小投保越便宜	回族的儿童的风险是,越小的便宜
给一岁女孩买慧馨安十万保额保期20年的话一年交多少钱。	买一个岁的女孩汇鑫字安米20年额每年数以千计支付多少钱。
听说一起慧99在对大病报销的时候保额还会翻倍是的吗？	听说99年回族大病报销在报道将双是吗?
集成吊顶代理加盟要什么条件？听说这个项目最近比较火	集成吊顶剂加入在什么条件下?
惠*安的产品特色是什么	安回族*产品特性
一起慧99只能当做保障，没有分红吗	回族99只作为保证,没有股息
一起慧99保险在理赔的时候住院金索赔需要什么材料	回族99住院保险索赔在黄金声称需要什么材料
当下火热的慧馨安少儿险值不值得买	目前热汇鑫小危险是值得购买
慧*安*儿重疾险的特定重疾能赔付多*	安回族* *的儿子重疾病某些疾病的风险可以支付*
慧馨安少儿重疾险跟其他公司的保险相比有什么优势	汇鑫安儿童严重疾病风险与其他保险公司相比有什么优势
一起慧99如果没到期退保的话返还保费是怎么算的	回族99一起如果不是因为退保险费如何计算的回归
一起慧99在理赔的时候流程是怎么样的	回族99在索赔过程
一起慧99第一年有理赔想第二次再投保的话等待期是多久	回族99第一年一起索赔保险第二次等待期多久
百万医疗险一起慧99所谓的复购权益指的是什么？	数百万回族99后一起所谓的购买权利意味着什么?
一起慧99能报销意外伤害的治疗费用，最高报销多少	回族99一起可以报销意外伤害的治疗,费用最高
儿童节买保险，给孩子选择什么样的健康险好	儿童节买保险,选择什么样的健康保险的孩子
打算给老婆买份保险保健康的保额高免赔额低的有没有	去买我的妻子健康保险的保险有较高的免赔额
一起慧99这样的一年期的保险是不是都不保证续保	回族99是一个为期一年的保险并不保证所有的同意
是不是连续两年投保一起慧99有优惠	这是回族99连续两年在一起的折扣
本人有社保，再买份商业医保怎么投保?	我有社会保险,然后购买商业健康保险?
现在孩子的保险好多，要怎么给孩子买好	现在的孩子很多,如何买的孩子
一起慧99对于膳食费报销有限制吗？最高可以报多少呢？	回族99一起吃饭有限制报销吗?
看到说一起慧99百万医疗保险对特殊门诊也能报销，具体包含了哪些费用	看到说回族9900万医疗保险一起特殊门诊可以报销,具体包括在内
有什么样的健康险，报销看病住院买药啥的这些费用的	什么样的健康保险,申请一个医生在医院买药这些费用
孩子上幼儿园，打算给小孩子投保一份医保，买什么样的好	孩子们在幼儿园里,以确保儿童健康保险计划,买什么好
想给孩子购买一款保险，最好是免赔额比较低的那种有什么好的产品推荐吗？	想给你的孩子买保险,最好是免赔额低推荐好的产品吗?
慧择网零免赔额的百万医疗险和市面上热销的百万医疗险相比有何不同？	回族选择零的数百万人与数以百万计的热销市场上有什么区别吗?
买份保期时间长的保险，有没有好的推荐	买米长保险,你能推荐一个好
大家怎么看待市面上的零免赔额的百万医疗险？	你认为零免赔额数百万的市场卫生保健?
最近有保额百万的产品吗，适合年轻人买吗	最近有成千上万的产品,适合年轻人去买它
孩子有一岁多了，请问有没有合适的高保额保障的健康险投保	孩子一岁多,有没有合适的高溢价是保证医疗保险
请问有没有商业健康保险报销社保外的一些医药费用，范围广的那种	商业医疗保险报销以外的任何人有社会保障,医疗费用的范围很广
想在六一前给家里孩子办理份保险，能报销住院医药费这些的，有没有推荐的	想在家里给孩子在孩子们面前处理保险,可以报销住院医疗费用,推荐
已经有社保了，但是还想办理一份保额高的保险，请问有推荐的吗	已经有社会保障,但也想处理高覆盖率的保险,你有推荐
父母刚到五十岁，想买份健康类保险，保障高的有吗	父母五十岁,想买一个医疗保险,保障高
一起慧99的保额是多少？最高保额	额头是回族99在一起吗?
马上六一了，想给上幼儿园的孩子买份健康险，求推荐？	孩子,想幼儿园的孩子买健康保险,建议?
高保额低免赔这样的保险有没有	高覆盖率和低免赔额保险
六一儿童节就要到了,打算给孩子买份健康险,请问什么样的好	6月1日儿童节即将到来,要给孩子买健康保险,什么样的好借口
刚刚入社会，想给自己办理一份医疗保险，请问现在比较火的是什么？	刚进入社会,想给自己处理医疗保险,现在更多的火?
一起慧99的0免赔额是只要住院看病就给报销吗	回族99 0系列在一起只要医院看病报销
一起慧99在买的时候能报销医保之外的药品吗？	回族99可以一起报销购买时以外的卫生保健药吗?
一起慧99有没有等待期，我看很多保险都是90天，这个产品是多少天？	回族99一起等待时间,我看到很多保险是90天,该产品是多少天?
一起慧99理赔要多长时间？几个工作日能受理解决？	需要多长时间回族99一起索赔吗?
一起慧99是医疗保险吗可以报销哪些费用	医疗保险99年回族是可以报销的
百万保额的医疗保险哪里有？有这样的保险吗？	哪里有数百万覆盖的医疗保险吗?
一起慧99是零免赔额，相比有免赔额的产品真的好吗	与回族相比99年特许经营是零,特许经营的产品真的很好
慧择0免赔额的百万医疗险为什么这么火？	回族0系列选择是数百万为什么这么火?
报销一起慧99医疗保险的时候，只要在医院的花费都可以报吗	一起报销回族99年健康保险,只要可以提交到医院成本
一起慧99是什么保险，意外医疗伤害什么的也能保吗？	回族99在一起是什么样的保险,也可以保护意外医疗伤害还是什么?
打算买份医疗保险，请问一起慧99是不是真没有免赔额	会买医疗保险,你能告诉我99年回族不扣除
新华红双喜保利盈两全保险哪些保障比较好？	新华社红色聚满养老保险哪个更好?
新华福禄相随两全保险好不好？买的人多吗	新华社养老保险铁手好吗?
一起慧99保障高不高？最低保费是多少	回族99保证高不高?
新华福家安康终身健康理财保障计划怎么样?	新华社傅家人健康的终身医疗保险计划吗?
如果要买保险投保的话选择一起慧99怎样？	如果你想购买保险选择回族99在一起吗?
一起慧99这款产品如果报销一次还能续保吗	报销回族99如果这个产品还可以续签
新华红双喜喜来顺两全保险有返还吗？保障多吗?	新华社双喜养老保险安排返回满意吗?
孩子没有社保，只有农村保险，投保一起慧99是按有社保的价格还是没社保的价格呢？	孩子没有社会保障,只有农村保险,保险是回族99连同社会保障价格或不是社会保障价格吗?
一起慧99保证续保吗？续保有什么要求啊？	回族99保证同意在一起吗?
新华红双喜金富贵年金保险保障如何？买的人多不？	新华社红色杏捻年金保险吗?
有买过百万医疗险一起慧99的吗？不知道膳食费怎么算？要发票吗？要怎样的发票？	上百万的人买了卫生保健回族99在一起吗?
新华百年好合两全保险条款是怎么样的?保障多不多?	新华社好养老保险条款是一百吗?
慧择保险的0免赔额百万医疗险“一起慧99”保意外吗？意外住院能理赔吗？	回族0选择保险扣除数以百万计的医疗保险事故“回族99”?
一起慧99到底有什么优惠相比其他的保险	回族99的折扣比其他保险
百万医疗险“一起慧99”，真可以做到100%赔付？	回族99数以百万计的卫生保健”、“真能实现100%的支付吗?
新华红双喜盈宝利两全保险对于年轻人来说有没有投保的必要？	新华社双喜剩余波利养老保险保险所需的年轻人吗?
国寿瑞丰两全保险是怎么样的？父母买给孩子好吗	的养老保险ShouRuiFeng吗?
国泰瑞祥终身寿险能不能给小孩子开始投保了？多久开始比较好呢	国泰航空瑞祥终身人寿保险可以给孩子吗?
新华福寿安康终身健康保障计划到多少岁领取保险金？	新华健康长寿生活卫生保健计划多少岁要保险吗?
新*至尊荣御年金保险保障全面吗？有哪些内容？	新*最高荣耀帝国年金保险全面吗?
新华红双喜盈宝通两全保险投保好不好？是否值得买？	新华社双喜盈余鲍彤养老保险?
国寿智力人生两全保险能不能买？适合在什么年龄买？	的生命知识人寿保险可以满意的购买?
国寿肿瘤预防疾病保险买了有什么好处？	生命的癌症预防、疾病保险买了有什么好处?
新*荣享人生养老年金保险真的有养老的作用吗?	新*荣享受养老年金生活真的有养老金的影响吗?
国寿鸿信消费信贷定期寿险是可以贷款的吗？	宏鑫的生活消费信贷定期寿险可以贷款?
平安安享住院费用医疗保险最高能报销多少费用？	能报销最高和平享有住院医疗保险成本?
国寿康裕重大疾病保险保费高不高？一年要多少保费？	ShouKangYu重大疾病保险成本不高吗?
国寿关爱一生终身寿险从什么时候买正合适？	一生的爱情生活的生命从什么时候购买是合适的?
国*珍*一*住*医疗保险最高能报销多少？	* * * *一个简最高报销医疗保险呢?
国寿学生意外险是给什么年龄的孩子买的?	学生购买意外保险的生活什么年龄的孩子?
新*好利年年两全保险是给哪些人买最合适的？	新*好年复一年,养老保险是最适合人们买什么?
国寿绿洲团体意外险是出游的时候买的吗?	的生命绿洲群伤亡是时候去买什么?
国寿神州紧急救援意外伤害保险适合什么人买	神舟紧急的生活对人们购买意外伤害保险
平安金福康好不好？五十岁的人还能不能投保这个？	和平金富康好不好?
国寿长久呵护意外险有哪些保障？保障期限长吗	长期护理保险的保障生活是什么?
平安富裕一生可以从中年阶段开始买吗？父母今年四十多岁能不能投保？	和平可以丰富生活,从开始购买?
国寿母婴安康意外险可以多什么样的孕妇买？	孕产妇和婴儿的生活健康保险可以什么样的孕妇购买更多?
国寿学生儿童意外险怎么样有学平险还要给孩子买这样的吗？	学生的生活孩子伤亡如何平给孩子购买此类风险?
国寿鸿运少儿两全保险好不好？给我家孩子买合适吗？	养老保险是好小好吗?
国寿绿舟定期寿险缴纳年限是多长时间？要交多少费用？	绿色船舶的生命定期人寿保险缴纳年限是多久?
新华吉祥至尊保险是个什么保险？有分红吗？	新华社吉祥主权保险是什么保险?
国寿鸿宇两全保险保障多不多？都有哪些内容？	有许多国家ShouHongYu养老保险?
中国人寿鑫福年年怎么样？中年人能不能买	每年中国人寿,鑫富?
新华红双喜保险有没有返还分红？能返还多少？	新华社双喜的分红保险吗?
国寿防癌疾病保险保障内容多吗？	生命的癌症疾病保险内容?
国寿学生儿童定期寿险最长是缴纳几年？有什么保障？	最长的定期寿险学生儿童的生活付出几年?
国寿夕阳红意外伤害保险是适合多少岁的人买的	日落的人生意外伤害保险是多少岁的人购买
平安世纪天使少儿两全保险可以给已经上幼儿园的孩子买吗？	世纪和平天使儿童养老保险可以买到幼儿园的孩子吗?
国寿独生子女保险有没有必要买这样的产品？	独生子女保险的生活需要购买这个产品吗?
平安金利多两全保险如何？保障多不多？	和平,显示更多的养老保险?
国*康*定期重大疾病保险适合刚结婚的人买吗	* *定期适合新婚人们购买重大疾病保险
新华健康福享买要多少钱一年，是个什么保险	新华健康f一年要花多少钱买,什么是保险
国寿祥泰定期寿险年缴费多少？买多少年合适？	定期寿险的ShouXiang泰国付款?
国寿福禄满堂养老年金保险到多少岁领取保险金？	ShouFuLu和养老金保险多少岁要保险吗?
平安守护星*儿两全保险给孩子从什么时候开始买好	儿童安全防护star *儿子养老保险从什么时候开始购买
中*人寿大瑞鑫是个什么保险？好不好	*生活大瑞鑫是什么样的保险?
安联安途好不好？保障怎么样？	安联安妥好不好?
aig保险有官网吗？在哪里能买到美亚的旅游险？	Aig保险有一个网站吗?
平安福终身寿险好不好？保障多不多？	和平整个的生活呢?
华夏旅游保险多不多？怎么买旅游险	中国有很多旅游保险。
绿野户外网保险多不多？和慧择网相比产品多吗	有许多向导户外净保险吗?
平安护身福终身寿险怎么样？投保好不好	安全防护f一生?
平安鑫祥两全保险适合给孩子投保吗？什么年龄合适	养老保险新平安吉祥的被保险人的孩子?
中*平安赢聚一生是理财保险吗？有什么作用？	*和平赢在一起生活是融资保险吗?
美亚保险上*可以买到吗？美亚的保险贵吗？	Aiu保险*可以买吗?
平安常青树保障多不多？什么年龄能买	平安常青树安全得多。
平安快乐旅程是个什么产品？保障多不多？	什么类型的产品是安全的,旅途愉快吗?
中英人寿户外保险好吗？有什么好处	中英人寿户外保险吗?
平安旅行险怎么样？保费是多少境内旅游的话	安全的旅行保险吗?
平安畅行天下保障有哪些？多不多	什么和平占上风世界安全吗?
安联保险好吗？在慧择网上能买到吗	安联保险吗?
阳光安盛保险怎样？在慧择上能买到他们的产品吗	阳光安盛保险吗?
美亚保险验真怎么弄的？什么办法	Aiu保险检查真的怎么做?
美亚保险深圳能买到吗？可以直接上网去投保吗？	Aiu保险可以买在深圳吗?
安联保险排名怎么样？安联的旅游险要多少钱？	安联排名?
平安出境游保险买什么样的好，去国外旅游要怎么买好保险	平安境外旅行保险买什么样的好,怎么出国购买保险
美亚保险万*游踪产品好不好去美*的话可以买吗	Aiu保险所有是好的* *个人产品可以买
江泰旅游保险官网上的旅游险和慧择的比起来哪个多？	网站江泰旅行保险旅游保险和回族选择哪个多?
美*专业户外保险有哪几种产品，去登山买什么样的保险	漂亮的*专业户外保险有什么样的产品,什么样的保险购买登山
美亚户外运动保险买的人多吗？好不好	美亚户外运动保险购买多少?
华泰出国保险有什么保障？出国旅游的时候买怎样？	华泰保险出国呢?
磨房保险官网产品多不少？是不是慧择网更好些	机保险网站有多少产品?
磨房美亚保险产品有吗？是不是都是旅游险？	Aiu机是保险产品?
平安保险户外险好不好?去厦*玩的时候买好吗?	平安户外风险?
平安保险旅游意外险适合吗？清明旅游的时候买好不好？	平安保险(Ping an insurance)旅游保险适合你吗?
太*洋境外旅行保险保额要多少的合适？	太*多少合适的海外旅行保险吗?
绿野保险网和慧择网相比哪个更好点？	向导保险网络与回族选择网络哪个更好?
平安国外保险怎么买？可以去哪里买？	如何购买安全的外国保险吗?
江泰保险产品多不多？去哪里能买到？	江泰保险产品多少钱?
乐悠游是什么样的？去投保好不好？	游泳是什么样的?
美*境外旅游保险怎么样？适合国内游的人买吗	*海外旅行保险吗?
拉磨无忧户外保险能不能买？值得买吗出去玩的时候	,简单的户外可以买保险吗?
阳光户外保险产品多吗？哪些值得现在旅游的时候买？	室外阳光保险产品?
美亚保险怎么样？慧择网能买到吗？	Aiu保险吗?
美*美亚官网上的保险好不好，跟慧择网相比哪个更多？	*美国和亚洲保险官方网站是好的,而回族选择网络哪个更多?
美亚旅游保险国内的保险买什么样子呢？	美国国内旅游保险保险购买什么?
平安旅游意外险最低多少钱？	安全的旅行保险最低多少钱?
阳光境外保险去哪里能买到买什么样的好	阳光在哪里购买海外保险买什么好
美*出境游保险要买吗？出国的保险要怎么买？	*出境旅游保险购买吗?
美亚广州保险的产品多不多？	Aiu广州保险产品多少钱?
绿野保险是个什么保险？保障好不好	向导保险是什么保险?
美亚留学保险要买吗？留学生是不是必须要的	研究在美国和亚洲保险购买吗?
安联保险公司官网上的保险多吗？可以买吗	安联保险公司的官方网站吗?
旅游平安保险好不好,在国内现在的平安旅游险大概多少钱?	旅行平安保险是好的,在国内和平现在旅行风险大概多少钱?
华泰旅行保险适合现在去买吗	华泰现在购买旅行保险
美亚国际旅行保险大概度多少钱能买	美亚国际旅行保险大概多少钱可以买到
太*洋旅游保险好不好？在哪能买到？	太*旅行保险吗?
美亚*险*州出游的话买什么样好？	美亚只* *国家旅游买什么好呢?
磨房保险和慧择保险两个哪个更好点？	保险和保险的回族选择两个磨房更好?
美亚骑行保险要怎么买更为合适些？	如何获得更合适一些美国骑保险吗?
北京美亚的保险产品多不多？去哪里买到？	北京有很多aiu保险产品。
磨房论坛上的保险多吗，跟慧择比哪个上面的保险好些？	机超过保险BBS,回族选择比上述保险?
美亚万国游踪保险怎么样？出国适合买吗？	联合国飞行员保险吗?
安联出境保险要多少钱投保好	安联退出保险要多少成本
平安一日保险怎么样？和有合适的产品吗	平安保险(Ping an insurance)一天吗?
美亚保险旅游产品多不多？春天出游要买多少钱的好	Aiu保险有很多旅游产品。
太*洋国外保险保障怎么样？能不能买？	*外国保险?
美亚上海能买到合适的保险吗？旅游险怎么买？	Aiu上海能买到合适的保险吗?
美亚境外保险好不好？给去美*玩的朋友买好吗？	美国以外的国家和亚洲保险吗?
美亚户外保险适合哪些户外活动？保障全面吗？	美国以外的国家和保险适合户外活动吗?
平安智慧星适合给孩子买吗?	给孩子买和平智慧星吗?
新华保险的产品多不多？给父母买什么样的比较好？	新华保险产品多少钱?
美亚的旅游险怎么样？保障高吗？	美国旅行保险吗?
美亚官网保险上买旅游保险行不行？周边旅游买什么样的旅意险好？	保险在曼联的官方网站购买旅游保险行不行?
新*健康无忧是个什么产品？保障多吗？	新*健康无忧的产品是什么?
医疗保险一年多少钱？中老年买医疗保险可以吗？	医疗保险一年多少钱?
婴儿适合买什么保险？哪些保险比较好	婴儿衣服买什么保险?
太平洋安行保好不好？投保保障怎么样？	太平洋确认好不好吗?
华夏马上赢产品好不好？适合四十岁人买吗？	中国立即赢得产品吗?
国*康*重大疾病保险保障好不好，怎么买？	* *重大疾病保险,如何购买?
少儿保险的险种哪些是最应该要给孩子买的？	儿童保险也是最应该给孩子买什么?
康宁保险适合哪些人买？产品保障怎么样	康宁对什么人买保险吗?
阳光保险的产品适合给父母购买？哪些产品能买？	阳光保险产品适合父母买什么?
两全保险是什么保险，成家立业的人买什么样的两全保险好？	什么保险,养老保险是已婚人士的两全买什么样的保险好吗?
儿童大病保险怎么买？给小孩子怎么买医疗保险？	儿童疾病保险如何买房?
消费型重疾险是不是很便宜，中年人买合适吗？	中年消费者重疾病风险是非常便宜,买合适吗?
婴儿保险从出生什么时候买好？适合产品是什么？	婴儿从出生时买保险吗?
平安福给老年人买可以吗？	平安f为老年人能买到什么?
农银人寿的寿险能不能买，好不好？	农业银行人寿保险可以不买,好吗?
泰康全能保2015怎么样？保障多不多？	2015年泰康全能的保护?
小孩人寿保险适合买哪些产品？	人寿保险产品适合买什么孩子?
小孩适合买什么保险？在上小学之前给孩子买什么保险？	孩子买什么保险?
城镇居民医疗保险要不要办，已经有社保和商业保险了	你想做城镇居民医疗保险,这是一个社会保险和商业保险吗
儿童保险在五岁的时候买什么产品好，教育金产品要不要这个时候买？	5岁儿童保险购买什么产品好,教育基金会的产品这次你想买吗?
给小孩买什么保险好？小孩子的保险能买哪些？	什么是好的保险买一个孩子吗?
人寿少儿保险能给孩子投保吗?孩子三岁多怎么买?	可以为孩子生活孩子的保险?
宝宝保险现在能买吗？宝宝出生有好几个月了	宝宝现在可以买保险吗?
君龙鑫富利终身寿险怎么样？产品保障全面吗？	小君长欣一生?
重疾险比较好的有哪些？单身收入三四千买什么样的重疾险？	重疾病风险更好的什么?
老人保险在六十岁的时候能买哪些险种？	老年人保险是种植在60岁买吗?
适合中老年的保险多不多，能买哪些保险？	适合中老年保险多少钱,可以买保险吗?
大病险商业险给家里小孩子买要多少保费，普通家庭买多少钱的好？	破旧的大型商业风险儿童购买房屋保险多少钱,普通家庭买多少钱?
友邦保险的产品怎么样？买的人多不多？	友邦保险的产品吗?
人寿保险险种介绍的产品怎么样？	人寿保险是种植产品介绍吗?
太平洋人寿保险的险种多不多，给家里正在上*学的孩子买好吗	太平洋人寿保险是种了许多不多,你买回家是*上学的孩子
哪个疾病保险好？什么样的疾病保险保障的疾病更多？	疾病保险?
常青树保险好不好保费选择多少的好	有多少好常青树保费保险是不错的选择呢
给婴儿买什么保险好？哪些保险不能少	什么是好的保险购买婴儿吗?
华夏保险常青树怎么样	中国保险常青树
少儿人寿保险的险种哪些是必须要买的，孩子今年四岁寿险该怎么买	孩子的生活是一个必须购买保险,孩子今年4岁生活如何购买
平安福保险怎么样？给老年人买可以吗	f平安保险吗?
泰康全能保能保哪些，具体保障内容是什么	泰康全能的保护可以保护什么,什么是特定的安全
重大疾病医疗保险保额要选择多高的合适	重大疾病医疗保险选择正确的多少
重疾险哪个好？给小孩子买重疾险保费要多少	重疾病风险好吗?
意外伤害医疗保险买了好不好，这个和意外伤害保险有什么不同	意外伤害医疗保险买的是好的,有什么区别,意外伤害保险
华夏重疾保险一份要多少钱保费高不高	大病保险费是多少中国高不高
小孩保险哪些保险产品是不能少的	儿童保险哪些产品不能少
平安人寿险种多不多，经常出差的人能买什么产品	平安人寿保险是种了许多不多,经常出差购买什么产品
人寿保险对于刚结婚的人买什么样的好	人寿保险对刚结婚的人买什么好
太平洋金佑人生怎么样，保障多不多	太平洋金是如何你的生活,你有多少安全
华夏人寿常青树保障高吗给多大的人投保	华夏人寿常青树保护高,请给多少人保险
网上保险投保安全吗现在在网上买放心吗？	在线保险现在是安全的在网上买吗?
少儿医疗保险是孩子出生以后就能买吗	儿童健康保险出生的孩子在未来将能够购买
富德生命人寿怎么样，可以选择的产品多吗	富尔德生活,如何选择产品
重疾险能不能给小孩子办理，孩子才三岁能买吗	重疾病风险可以给孩子,孩子只有三岁可以买
合众人寿保险怎么样，作为婚后的上班族能买什么产品	现代生活保险,作为上班族的婚姻可以买什么产品
商业医疗保险多少钱一份	商业医疗保险多少钱
德*签证保险怎么买？	德*签证买保险吗?
天安人寿卖的保险好不好？	天安人寿卖保险?
汽车保险怎样买	如何购买汽车保险吗
出租型房屋保险如何投保	如何确保租赁住房保险吗
私家轿车强制险多少钱？	私家车强制保险多少钱?
华夏人寿的保险怎样小地方也能买到吗	中国人寿保险多小的地方也可以买
退办医保卡需要什么手续吗？	返回一个医保卡需要哪些手续?
车船税去哪里交	车辆和到哪里去
汽车保险怎么买	如何购买汽车保险吗
生育保险怎么报	生育保险报价
二手车保险需要买哪些	需要买什么二手车保险
保险续费延期多长时间	需要多长时间保险更新扩展吗
厦*报销生育保险需要提供什么材料	大厦*报销生育保险需要提供什么材料
个人养老保险怎么缴纳	如何缴纳个人养老保险
机动车强制保险最多能报销多少钱	机动车强制保险可以报销多少钱
西*牙签证保险怎么买？	西牙*签证买保险吗?
费改后车险续保注意哪些事项	改变汽车保险费用后续订通知什么项目
我二十岁买养老保险怎么买？	我今年20岁,如何购买买养老保险吗?
养老保险和医疗保险的区别是什么	之间的区别是什么养老保险和医疗保险吗
新车需要买的保险有哪些	什么是保险需要买一辆新车吗
购车一年，都需要买哪些保险合适？	汽车一年,需要买什么保险?
今年五十岁了是否还可以买社会养老保险,能领养老金吗?	今年五十岁,如果我还可以购买社会养老保险,会导致养老金吗?
新车第二年车损险续保要注意什么	新车在第二年的车损险同意注意
新华人寿保险怎么退保？	新华人寿保险投降吗?
车险赔款如何领取	汽车保险赔偿如何接收
医保卡丢了怎么办	医保卡丢了
农村户口怎么买养老保险	农村户口买养老保险吗
婴幼儿2016的社区医保怎么办理	婴儿和婴儿2016社区医疗如何处理
现在买车需要交哪些保险？	现在买一辆车需要支付保险吗?
生育保险报销比例是多少	生育保险报销比例是多少
办理养老保险转移需要多长时间	需要多长时间办理养老保险转移
车子未交强险驾驶员有什么处罚吗	汽车没有支付保险试点的惩罚
车险续保需要什么证件	汽车保险续签需要什么证件
养老保险交15年后可以不交了吗	养老保险缴纳15年不能支付
重大疾病保险一年多少钱，怎么买重大疾病险划算	重大疾病保险一年多少钱,如何购买重大疾病保险值得的
车辆保险去年不出险，今年续保，一般优惠多少？	车辆保险不是或者摆脱危险,去年今年更新,一般折扣吗?
潍*车辆能不能在滨州上车险	潍坊柴油机可以在滨州*汽车汽车保险
自由职业者如何缴纳社保？	如何支付社会保障自由职业者?
车辆保险不过户有影响吗	车辆保险但有影响力的家庭
如何退社保？	社会保障如何回来?
个人怎么办理社保	人们如何处理社会保障
车险怎么买最划算	买最便宜的汽车保险
现在学生要办社保吗	现在学生的社会保障
分红型保险退保怎么退	分红保险投降如何回来
申根签证保险哪家好	申根签证保险这很好
医保本丢了怎么办	卫生保健在这迷路了
个人怎样办理广州社保	如何处理个人社会保障在广州吗
购买防癌保险要注意哪些	癌症保险应注意什么
男员工也可以享受生育保险吗	男人也可以享受生育保险
养老保险可以跨省转移吗	养老保险可以跨省转移
强制保险包括哪些方面	强制保险包括哪些方面
第三者责任险必须买吗？价格便宜不？	第三方责任保险有买吗?
五菱货车商业保险第三者保险大约需要多少钱？	五菱的第三方商业保险需要多少钱?
人寿保险已过犹豫期退款怎么样退，扣不扣钱	人寿保险犹豫如何问题退款已经回来,扣没有钱
意外伤害保险多少钱，在哪里买划算	意外伤害保险多少钱,你在哪里交易
如何办理境外保险	如何应对海外保险吗
保险种类有哪些，保险分类，保险类型	什么类型的保险,保险类别,类型的保险
异地购车怎么购买交强险。打个电话能买吗？	长途汽车如何买保险。
购买商业医疗保险后多久可以使用	购买商业医疗保险后多久可以使用
汽车强制险过期了一个月会罚款吗	汽车强制保险过期罚款一个月
车险上路机动车未粘贴保险标志会受到什么处罚	汽车保险机动车上没有粘贴保险标的将受到惩罚
医保和农合是一回事吗?重复了有效吗	医疗保险和农民是一样的吗?
在银行买保险和在保险公司买保险有什么区别	在银行买保险和之间的区别是什么保险公司购买保险
靖*县医保报销需要什么材料	京*县保险报销需要什么材料
异地养老保险可以随时转回老家吗?	不同的养老保险可以回头吗?
买保险需要什么证件吗	买保险需要什么证件
上*车上*保险在无*出险如何理赔	没有* * *的汽车保险赔偿的索赔
如何办理养老保险跨省转移	如何应对养老保险跨省转移
异地就医医保如何报销	远程医疗医疗报销多久
养老保险个人交与单位交的区别	养老保险个人单位支付的区别
福*医疗保险卡去贵*用吗?	医疗保险卡f * *使用吗?
商业养老保险是否有投保年龄限制	如果有一个覆盖商业养老保险的年龄限制
生育保险报销流程,怎么报销	生育保险报销流程,如何报销
二手车过户后保险该怎么办理过户	二手车过户后保险如何处理转移
保险经纪人与保险代理人有何区别	有什么区别的保险经纪人和保险代理人
自燃险属于独立险种吗	自燃风险属于独立的报道
车子卖了，但是保险没有过户怎么办	车卖了,但是保险不转移
个体户办理养老保险需要什么材料	Soho养老保险需要什么材料
办养老保险缴费凭证需要哪些资料	哪些数据需要做养老保险费证书
美国航空保险主要有哪些	主要的美国保险是什么
离职后医疗保险怎么办	离职后医疗保险
商业保险属于社会保险吗	商业保险属于社会保险
个人办社保需要什么条件	个人社会保障办公室需要什么条件
齐*牌照在哈*滨*车*行*	*牌照的车哈* * * *
个人买养老保险多大年龄可以领取保险金	老人买养老保险如何得到保险金
个人如何缴纳社保缴纳方式有哪些	个人如何缴纳社保是什么支付方式
贺*人去桂*生孩子可以报生育险吗	孩子去广西,* *可以报生育风险
防癌险和重疾险的区别	癌症风险和沉重的疾病风险之间的区别
储蓄和保险的区别在哪里	有什么区别储蓄和保险
重*市非本地户口新生儿如何参保	*多重城市本地户籍的新生儿人参
自用车保险中的代收车船税怎么计算的	自从汽车保险的计算收集车辆
赤*的车在锦*能办车险吗	红金* *的车可以申请汽车保险
单位车辆办理车险需要什么手续	单位车辆汽车保险需要办理什么手续
二手车保险过户需要什么手续	二手车保险转移过程所需要的东西
在安*结婚的重*上班的可以报生育保险吗	沉重的* *结婚安能报生育保险工作
养老保险手续应该怎么办？	养老保险应该怎么做?
车过户保险怎么办	汽车保险转移
芜湖汽车在南*可以买保险吗	芜湖汽车在南*可以购买保险
公司职工参保与自己购买的商业保险冲突吗	企业职工参保和商业保险购买自己的冲突
有生育险，怎么报销	有生育风险,如何报销
滁*新农合可以在南陵报销吗	锄禾*新农业可以部分报销
交强险是什么意思在事故中夲人全责，可以得到保险吗？	的意义是什么保险事故责任的人,可以得到保险?
男士参生育保险有什么用？	男人和生育保险有什么用?
外地车如何在天*办车险	天*车险的外国汽车如何处理
珠海社保转入永州流程	珠海社会保障到永州的过程
保险公司赔偿误工费怎么算,最少算多久	保险公司弥补失去的工资是多少,至少计算多久
苏*的车子可以买陕*保险吗?	这辆车可以买山苏* *保险吗?
湖*省的车在贵*平*可以买车险吗	湖平的车在你的* * *省可以买汽车保险
交强险理赔缺身份证复印件能赔吗	保险索赔缺乏身份证复印件来补偿
新公司办理社保需要哪些资料？	新公司办理社保需要什么数据?
车险理赔案件的有效期是多久	多久是汽车保险索赔的有效期
什么是自愿保险和强制保险	保险自愿和强制保险是什么
网上怎么买保险有哪些注意事项	有什么注意事项网上怎么买保险吗
在成*贷款买车需要买哪些车险？	*贷款买车需要买汽车保险吗?
农保和社保的区别	农业保险和社会保险的区别
酒驾死亡会得到保险公司的赔偿吗	酒后驾车死亡将由保险公司赔偿
在湖*买社保可转回江*吗	湖买社保可以转回江* *
车险在大*买的,在沈*可以续保吗	汽车保险在大* *买沈可以更新
重大疾病险包括哪些疾病及投保重疾险需要注意什么	什么疾病和重大疾病保险包括严重疾病的风险需要注意
无过责任险是什么意思?无过责任险有必要买吗?	你什么意思没有责任保险?
汽车保险过期可以过户吗	汽车保险到期可以转让
可以用保险申请贷款吗	您可以使用保险申请贷款
车辆保险可以过户吗，需要办理哪些手续	车辆保险可以转移,需要办理什么手续
太平人寿能办理异地车险吗	太平天国的生活可以处理不同的汽车保险
买二手车保险没有过期可以过户吗	可以买一辆二手车保险没有过期转移
财产保险和人身保险的区别	财产保险和人身保险的区别
养老保险补办需要什么手续	养老保险需要什么手续
买了意外保险，意外保险怎么查询保单信息？	如何购买意外保险,意外保险信息查询政策?
农村养老保险可不可以一次性交纳？	农村养老保险可以一次性付款?
义*新农合与医保有什么区别	义*新农业和健康之间的区别是什么
恩*新农合在同济可以报销吗	呃*新农业在同济大学可以报销
新车的第二年车险应该上哪些，有什么需要注意的么	第二年的新车保险应该是什么,需要注意什么
公司买社保和个人买社保有什么区别?	之间的区别是什么公司买社保和个人社会保障吗?
浙*省*兴的车在贵*能买保险吗	在你的* * *省浙江兴汽车购买保险
重*市生育险交多长时间可以报销，怀孕后在交生育险能报销吗	重*城市生育保险多久你可以报销,怀孕后可以支付生育保险报销
嘉*失业金怎么领取的	贾*接受失业救济
池*城镇新参医保后什么时生效	池*新城和医疗保健有什么影响
保险理财和银行理财有什么区别	之间的区别是什么保险融资和银行融资
医疗险和重疾险的区别在哪里	卫生保健和疾病风险之间的区别在哪里
申报生育津贴需要什么材料	申报生育津贴需要什么材料
福*省报销生育保险需要哪些材料	F *省报销生育保险需要什么材料
湖*如何办理个人社保	湖*如何处理个人的社会保障
太平车险比如商业险在湖*买了交强险在杭*买可以吗	太平保险等商业保险在杭州买了保险在湖里* *可以买
商业团体养老保险合同生效后可以撤回吗?	商业社会养老保险合同生效后可以撤回?
团体意外险申报理赔材料是复印件可以用吗	集团伤亡报告称材料可以使用复制
退保是解除合同吗	投降是取消合同
安*六安牌照在浙*可以买保险吗	安*浙江菜肴许可证*可以购买保险
在上*交的养老保险能转到四*去吗	*支付养老保险可以变成4 *
社保开户的办理条件有哪儿些？	处理情况有一些社保账户吗?
社保和商业保险有什么不同之处	什么是社会保险和商业保险的区别
汽车保险车子是苏*的,从阜*买保险可以吗?	丘的汽车保险汽车是苏*,*可以买保险吗?
外地车险在京能办吗	外国汽车保险在北京可以做
保单年检主要检些什么	什么样的政策年检主要检查
人寿保险合同与财产保险合同的区别	人寿保险和财产保险合同之间的差异
户口在河*能在山*办医保吗	户口在山*河*可以处理的报道
香*重疾险的理赔程序怎么走?	甜*重病保险索赔程序?
车过户了保险还没有到期该怎么办理	改变汽车保险的名称没有过期如何处理
宕*医保卡丢了怎么挂失	挂失的*医保卡丢失
人在大武口生育险在银*怎么报销	吴大嘴巴的人生育风险银*如何报销
汽车保险中机动车损失险与盗抢险有什么区别	之间的区别是什么汽车保险机动车损失险和被盗
汽车商业险有必要上第三者责任保险吗	汽车商业风险必要的第三方责任保险
河*新农合在山*能否报销	* *新农业山区河流可以报销
新农合异地报销有没有重大疾病保险	新的农业在不同地面任何重大疾病保险
12岁孩子办理社区保险都需要什么手续，去哪里办理	社会保险12岁的儿童需要什么手续,去哪里要处理
小孩未满半岁可随父母保医保吗	年半以下儿童保险
新农合保险可以停买后来年再买吗？	新农业保险可以停止再买年后?
广*玉*市的医保卡在柳*能用吗?	宽* *城市玉健康卡在刘*工作?
大*失业期间怎么交医疗保险	大*失业期间如何支付医疗保险
户口在四*人在昆*可以买社区医保吗	户口在四个* *可以买社区卫生保健在昆明
车险温*牌照能在邵*交不	汽车保险可以在温邵*不*执照
深圳医保绍兴能用吗	深圳医疗绍兴工作
年金保险于分红保险怎样界定	定义养老保险保险的分红
什*市的户口在都*堰生育能报保险吗	在所有账户* *城市堰生育保险报价
青*劳*局规定多大年纪可以领生育险	绿色* *局法律几岁可以生育保险
汽车上的强制险标示和汽车年检标示是怎么看的，代表什么意思？	汽车和汽车上的强制保险标志标记你觉得年检,代表什么意思?
订立保险合同十天犹豫期内双休能退保吗	订立保险合同十天犹豫期可以双休投降
车险是长*的在济*出事故了怎么办	汽车保险是长* *一个意外
太平车险比如商业险在湖*买了交强险在杭*买可以吗	太平保险等商业保险在杭州买了保险在湖里* *可以买
带行驶证和驾驶证可以办理车险吗	与车辆许可证和驾驶执照可以处理汽车保险
车险中的第三者险包括哪些？	第三方风险的汽车保险包括什么?
重*生娃娃拿去四川报生育险要哪些证件	出生时重*娃娃去四川是什么证书
16周岁的孩子买人身保险有什么限制吗	有什么限制16岁以下儿童购买保险吗
企业补充医疗保险与商业补充医疗保险有什么区别	企业补充医疗保险、商业补充医疗保险的区别是什么
社会医疗保险停了一年可以报销吗	社会医疗保险已经停止一年可以报销
新车购买车险流程	新车购买汽车保险过程
锦*的车保险帖丢了怎么?	金*后失去了汽车保险吗?
申报生育险需要什么资料？	申报出生危险需要什么数据?
订立保险合同时投保人应具备哪些条件	订立保险合同时,投保人应该有什么条件
江*车可以在防城港买保险吗?	江*车在防城港可以买保险吗?
如何生育保险办理	如何处理生育保险吗
登*市*道*办理新农合需要什么材料	* * *城市应对新农民需要什么材料
南*买的车,在西*买车险,能理赔吗	南*购买汽车,在西方*汽车保险,可以索赔
满了55岁但还没满56岁能买人身意外险吗	满55岁,但是在56岁之前,你可以买个人身保险
*光保险在贵*买的车险单掉了怎样补	在你的* *光保险购买汽车保险列出如何填补
强制车险过期怎么罚款	强制保险过期如何好
长期在海上打鱼怎样购买人身意外伤害保险	如何购买在海里钓鱼很长一段时间的人身意外伤害保险吗
深圳生育保险能在汕*用*	深圳可以在砂岩生育保险,* *
运费险是啥意思	货运风险是什么意思
美*人都在买什么人寿保险	美丽的*人们购买人寿保险
互联网保险和传统保险的区别在哪里	互联网和传统保险保险有什么区别
本人没身份证可以买保险吗	我没有身份证可以买保险
保险退保犹豫期怎么界定	如何定义保险投降犹豫地问题
在重*买的生育险,在海*生小孩能报销吗?	在重买生育保险,在海里*婴儿能报销吗?
新农合异地怎么加入	新农业和长途如何加入
农户大病保险办理流程	农民大病保险交易过程
合*车可以在桐*买交强险吗	或者可以在东* *车买保险
知道保单号可以退保吗	知道保单编号可以投降
广*贺*车牌可以在佛*购买交强险吗	宽板可以在* *购买保险,*
犹豫期和宽限期期间退保的区别方面	犹豫期,在宽限期投降的不同方面
用人单位必须为劳动者无条件购买哪些保险	用人单位必须无条件的什么保险的工人
汽车保险种类有哪些？	什么样的汽车保险?
外地车,外地身份证能在浙*买车险吗	外国汽车,外地身份证可以买汽车保险浙江*
退保险没有合同可以退么	返回保险合同不能返回
在东*买人身意外险在青*能保吗?	在东方*可以在绿色购买个人保险*保险吗?
保险公司新单犹豫期节假日除外吗?	保险公司新单犹豫期除了假期吗?
陕*子*生育保险夫妻双方都可以报销吗	山* *的儿子生育保险夫妻双方都可以报销
生育险交多长时间可以报销	生育保险多久你可以报销
网上如何购买车辆保险发票怎么办	如何在线购买车辆保险发票
城镇户口能交新农合养老保险吗	城市户口做出新的农业和养老保险
如何界定国内货物运输保险的责任范围	如何定义在国内货物运输保险责任的范围吗
商业养老保险与农村新农保冲突吗	商业养老保险和农村新农保持冲突
商业保险与社会保险区别	商业保险和社会保险的区别
小孩有出生证明可以买商业险吗，出险可以理赔吗	孩子出生证明可以买商业保险,声称它可以或摆脱危险
东*车牌可以在重*买保险吗	东在沉重的* *板可以购买保险
**哈*的失业金可以在南*领取吗	哈* * *的失业救济金可以声称在南*
人身保险主要种类有哪些？	人身保险主要物种?
我有一个人身保险存单丢失怎么?是需要挂失吗？怎么办里？	我有一个个人保险证书丢失如何?
广*贺*车牌可以在佛*购买交强险吗?	宽板可以购买保险,* *,* ?
湖*的生育保险能不能在湖*用	*可以生育保险在湖里,湖里*
出事故七八天强险报了商业险还能报吗	强大的事故QiBaTian风险业务风险也将报价
淳*县医保卡丢了怎么办	春*县医保卡丢了
车辆出险以后续保费怎么计算	车辆或摆脱危险的后续费用如何计算
理财保险能过户么	金融保险可以转移
有在慧择网买保险被骗的吗？一会儿问题就会被屏蔽或删	在回族选择网络购买保险被骗?
车辆撞人逃逸后,保险公司不予理赔吗	汽车撞人逃逸后,保险公司不得索赔
报销生育保险需要哪些材料	报销生育保险需要什么材料
蚌*市生育保险生完孩子后怎么报销	蛤*城市生下孩子后生育保险报销
张*的车在嘉峪关可以报车险么?	在嘉峪关张*汽车可以提供汽车保险吗?
失业金可以异地领取吗	失业可以是不同的
永*生育险报销需要什么证件和什么程序	从未*生育保险报销需要什么证书和程序
可以衢*上汽车牌照江西交交强险吗	瞿能交*车牌江西保险吗
合*的车子一年出险两次在合*买不了保险吗	*汽车每年两次在我们*不买保险
富邦车险怎么退保需要什么	富邦汽车保险如何投降的需要
宁*牌照可以去株洲买保险吗	可以更好地*执照在株洲买保险吗
甘*车牌可以在其他省会买保险吗?	在其他省会f *车牌可以买保险吗?
重疾险的保单提交后，需要多久能收到保单？	提交重大疾病保险,需要多长时间来接收政策?
苏州牌照的车在信阳能买保险吗?	苏州牌照的车在信阳可以买保险吗?
湖*车损险中的基本保费是如何规定的?	基本保险费湖*车损险是如何提供?
误工费怎么赔偿。伤者要提供哪些资料	如何工作的补偿。
保险中的被保险人概念是什么?需要什么条件	被保险人在保险的概念是什么?
刚买了保险可以退保吗？	可以买保险投降吗?
乌*木*牌照的车在喀什能不能买交强险	Uri * *木许可在喀什,你可以购买保险
在无*可以买兰*的车辆强险吗	没有汽车强* *可以购买风险
意外险包括哪些范围	伤亡什么范围
商业医疗保险和社保能一起报销吗	商业医疗保险和社会保障可以一起报销
购买香*保险后理赔和就医需要到香*吗？	甜*保险索赔和*后需要去看医生吗?
重大疾病保险为什么要确定必保疾病？必保疾病有哪些	为什么确定重大疾病保险将保护疾病?
小车交强险续保，没有车主身份证，有行驶证可以吗？？	汽车保险更新,没有所有者id、汽车执照吗? ?
老人户口本可以办保险吗	老人可以户口本保险
持q1签证要在美*待半年,应该买什么保险	Q1签证*在美国呆半年,应该买什么保险
保单怎么申请的全额退保	如何申请的政策完全投降
新华保险合同丢失怎么办	新华保险合同丢失
新车异地怎么年检？怎么较保险，车船税，	新汽车年检长途吗?
儿童把别人撞伤能用意外险吗	孩子可以把人受伤的牺牲品
工地买了建工险，出了事故多长时间上报保险公司有效	多久买一个建筑工地的风险,保险公司的事故报告是有效的
学生保险第一次保就发生了疾病第二次还能续保?	学生保险首次可以保护疾病发生了第二次更新吗?
哪些属于交强险，哪些又属于商业险	属于保险,属于商业保险吗
美*房屋保险的索赔有时限吗？	*家保险索赔有时间限制吗?
三年前买的保单可以贷款吗	三年前购买保险可以贷款
车辆是济*的可以从莱西买保险吗	车确实是*可以买保险的花边
外地牌照在杭*可以买保险吗？是不是会贵很多？	外地牌照*在杭州可以买保险吗?
安邦保险退保几天到帐	商业保险账户几天投降
金*可以给台*车辆上保险吗	黄金* *车辆保险
商业险里每个险种都可以买不计免赔吗？	商业风险在每个险种可以买到不包括特许经营吗?
二手车过户后保险也要去过户吗	二手车转让保险将改变名字
新华保险保单丢失怎么退保	新华保险政策贷款损失
车辆发生全损赔偿后盗抢险能退吗	总薪酬后车辆被盗可以退休
慧择网与保险公司网站的服务区别	回族选择网站与保险公司的服务
在保险公司买的保险把保单给丢了，怎么办？会理赔么	在保险公司购买保险政策丢失,怎么办?
保单的账户里的款能否被冻结？	政策的资金账户会被冻结吗?
定损后多久能赔付到帐	多久后可以支付的费用帐户吗
保险保单里的观察期一个月是怎么意思？	观察期间的保险政策是一个月你的意思如何?
基本医疗保险与大病医疗保险有什么区别	有什么区别的基本医疗保险和大病医疗保险吗
十*车能在随州买保险吗	在随州十*车可以买保险
慧择网买保险靠谱吗？不是骗人的网站吧？	回族选择由光谱净购买保险?
犹豫期退保用户口本行吗	犹豫期贷款帐户的银行
社保跟保险有什么区别	社会保障和保险的区别是什么
残疾人在工地干活是不是买不到保险	在建筑工地工作的残疾人是不能买保险
保险生效十三天可退保吗?是交金额几成?	影响保险十三天投降?
在辽*省*州*自己开店怎么给员工办保险	廖* * *省国家保险的员工,他们的开店
武*车牌可以在株*买车险吗?	吴在植物* *板可以买汽车保险吗?
人身保险合同丢了怎么办	失去了人身保险合同
车辆被盗保险退保需要什么	车辆盗窃保险需要投降
年满18岁以后用什么保险？	至少18岁以后什么样的保险?
美*老年人怎样参加医疗保险	*如何老年人参加医疗保险
武*汽车保险理赔是怎么办理的	吴*汽车保险索赔如何处理
机动车没有买保险在路上行驶有罪吗	汽车在路上没有买保险是有罪的
在天猫上怎么买人身意外险	如何在淘宝商城买人身保险
驻*店的车在济*缴的保险可以理赔吗?	在* *店的车能支付保险索赔?
买保险受法律保护吗	买保险是受法律保护
安康两全保险合同丢了怎么办	安康养老保险合同
个人保险是怎样避税的？	人身保险税吗?
不同工种购买的旅游保险有差异吗	有不同类型的工作之间的差异购买旅行保险
寿险保单犹豫期保单遗失如何补办	犹豫期政策失去了如何补办一个人寿保险政策
购买的平安安康A不超过五天可以退吗？	买的平安安康不超过五天可以返回?
车辆变更车险作废吗	汽车改变了汽车保险无效
65岁老人随迁深*户口能买重病险吗?	65岁之后,破旧的深*户口可以买到重吗?
人身保险可以退保吗	人寿保险可以投降
保全保单退保需要提供那些资料	安全政策投降将需要提供这些信息
什么是自愿保险和强制保险，二者有什么区别	是什么保险自愿和强制保险,两者的区别是什么
理财保单丢失怎么补办?	金融政策失去了如何填补?
泰*教师意外险需要什么证件	泰*老师伤亡需要什么证书
三责不计免赔险是什么意思	三个主要包括特许经营风险是什么意思
建筑意外伤害保险是强制性保险吗	建筑意外伤害保险是强制保险
太*的车险在翼城可不可以交	*汽车保险在翼城县可以支付
广*职工养老保险可以补办理吗	宽*职工养老保险可以填补处理
储蓄分红险退保还有钱拿吗？	储蓄保险分红撤退和金钱吗?
在美*房屋保险的索赔程序是怎样的？	*在美国家庭保险索赔程序是怎样的?
屋顶漏雨修防水属于财产险责任吗	防水屋顶漏水维修责任和财产
喝酒后乙醇中毒,买了意外保险能报吗?	饮用酒精中毒后,买了意外保险能报吗?
网络互助保险属于保险范畴吗？	网络互助保险属于保险的范畴?
嘉*市生育险怎么报销？需要准备哪些资料	贾*城市生育保险报销吗?
车内财物被盗保险公司理赔吗	汽车被盗财产保险公司索赔
威*落地险办理手续	*出生保险手续
代位追偿哪年开始执行	代位追偿,开始执行
生育保险可以报销流产费用吗	生育保险报销可以堕胎
交保险1天能退保吗??	1天能支付保险投降吗? ?
城镇医疗保险跟新农合有什么区别	之间的区别是什么农民新医疗保险吗
泰康保险犹豫期内申请撤单几天可受理	泰康人寿保险犹豫期申请取消几天可以被接受
购买人身简易保险期间，受到意外伤害医疗费能否理赔？	简单的个人保险期间,意外伤害医疗索赔吗?
机动车辆保险与船舶保险以及航空保险的区别与联系	机动车辆保险和运输保险、航空保险的区别和关系
广*的车险能在杭*买吗	宽*汽车保险可以买*在杭州
泉*车牌号在莆*能交强险吗	春天还在实现* *车牌保险吗
轻微擦伤的事故可不可以算意外保险	轻微的刮事故可以意外保险
生育险报销有时间限制吗	有时间限制生育保险报销吗
退养老保险需要办什么手续或什么证件之类的	回到办手续的养老保险或证书
福*泉*的车牌在贵*可以买保险吗?	F许可春天在你的* * *可以买保险吗?
企业在职保险是什么意思	企业保险是什么意思
交通肇事报销保险公司要什么手续	在交通事故赔偿保险公司办什么手续
人寿财产保险车子保单可以贷款吗	生命财产保险汽车保险政策贷款
主险的主附区别	的主要风险的主要区别
支付宝防癌险续保还有等待期吗	支付宝癌症风险更新和等待期
职工生育保险卡的作用是什么	职工生育保险卡的作用是什么
外地车在晋*可以买强制险吗	外国汽车在金*可以买强制保险
东*的车牌在河*买交险验车能行吗	东* *购买支付保险检查汽车车牌在河里
阳光同一张保单可以多次贷款吗?	太阳与保险政策可以多次贷款吗?
呼*车在赤*上保险可以吗	呼吁红* *汽车保险
男方生育险报销条件及流程	男性生育保险报销条件和过程
可以在保险公司买本次飞机的人身意外险吗?	可以买飞机的个人保险的保险公司吗?
车辆保险什么是基本险，什么是附加险	车辆保险基本风险是什么,什么是附加险
保单犹豫期退保可电话办理吗？	政策犹豫期所有者可以电话吗?
商务签证保险怎么办理?	如何处理商务签证保险吗?
公共责任险和公众责任险有区别吗	有什么区别公共责任保险和公共责任保险
保险报销事后理赔与事前给付有什么区别	之间的区别是什么保险偿付索赔之后,预付款吗
我一个人可以同时买十家商业医疗保险吗	我一个人可以买10个商业医疗保险在同一时间
给孩子办保险需要父母的户口本吗	保险的孩子需要父母的户口本
生育险从萧*转入永*需要办理什么	生育保险从肖* *永远需要处理
夫妻离异后还有保险继承权吗	丈夫和妻子离婚后的继承和保险
广*买的汽车商业险可以在湖*理赔吗	宽*购买汽车业务风险可以*声称在湖上
购买商业保险税前扣除被认定为偷税吗	买商业保险扣除因逃税被认为是
买了意外险,加班过程中被钢筋砸伤了脚踝,可以赔付吗	买了一个牺牲品,加班是强化猛击他的脚踝在这个过程中,你可以支付
厦*生小孩生育保险办么办理	大厦*婴儿生育保险的姚明
有商业保险可年龄大可以贷款吗	商业保险可以贷款
我在光大银行办理的保险合同丢失了,怎么补办	我失去了光大银行的保险合同,如何填补
残疾收入保险和长期护理保险的区别	残疾的区别收入保险和长期护理保险
买了交强险没买商业险碰了别人车能理赔吗	买了保险没有买商业保险索赔可以触摸别人的车
美*有没有社会保险	*社会保险
深*车牌可以在宁波买保险吗	*车牌可以在宁波买保险
买车险电话直销和柜台办理有什么区别	汽车保险直接电话和计数器有什么区别
电话车险和普通车险的区别	电话车险和普通的汽车保险的区别
平安的福享安康保重疾的有几大类,多少种	享受和平的祝福医疗疾病的几大类,有多少种
进行保险合同订立需要的条件有哪些	订立保险合同需要的条件是什么
有残疾证在新华保险能办重疾险吗	有一个残疾的新华保险可以做重疾病风险
出租房屋租金损失险是干什么用的,出租房屋租金损失险保障什么?	租赁住房租金损失的使用,损失危险安全租赁住房租金?
理赔死亡事故保险,可以在异地理培吗	声称死亡意外保险,可以在不同的地域文化
安徽人寿买的车险杭*可以报吗	安徽生活买汽车保险和杭州*可以引用
外地户口在阳信怎么买养老保险	外地户口在养心如何买养老保险
内*县*原*业*险*何*理	只在原* * *县* * *行业
企业养老保险自己怎么办理	企业养老保险如何处理
购买美*留学生保险需要什么资料	买保险*学生需要什么信息
小孩买教育保险需要那些手续	儿童教育保险需要这些手续
温*牌照可以在宁*保强制险吗?	温*执照在宁*强制保险吗?
用户口本可以买商业保险吗	与户口本你可以买商业保险
异地工作，怎么用生育险	不同的工作,如何使用生育风险
如何挑选美*人寿保险	如何选择*人寿保险吗
本人在九*有生育险,在南*生的小孩,怎么报销生育险,需要哪些材料?	在9 *有生育险,出生在南方*孩子,如何申请生育保险,需要什么材料?
保单贷款办理流程是什么	政策贷款交易流程是什么
贵*车上的户可以在凯里交保险吗	你可以在凯里*车门是保险
公共意外险给小学生买可以吗？	公立小学的学生伤亡能买到什么?
生育险报销需要准备什么材料	生育保险报销需要准备什么材料
合*车牌号六*市能不能年审买保险	可以在一起六* *车牌号码,年审买保险吗
内*县*原农业保险如何办理需要什么条件	* *县在原始农业保险如何处理什么样的条件
在佛*买的太平保险,汽车在东*可以报保险吗	在佛陀*太平保险,买汽车在东*可以报保险
保单贷款怎么办理	政策贷款如何处理
人民保险车险小额人伤保险申请需要什么	人民保险汽车保险小人们伤害保险应用程序需要
郑*的车能在洛*市买车险吗	郑* *汽车城市汽车保险
保单贷款两年内还不上怎么办	在两年政策贷款并不是如何去做
团体险是任何员工都可获赔吗?	集团保险是员工可以获得补偿吗?
保单贷款能办吗	政策贷款可以做
保单如何办理贷款	如何处理贷款政策
从杭*到常*怎么买货物运输保险	* *多久从杭州购买货物运输保险
库*勒妇科商业医保报销范围有哪些？	图书馆*勒的业务范围覆盖妇科?
房屋保险包括院墙吗	房屋保险包括墙
分红保险是婚因共同材产吗?	分红保险是婚姻常见材料生产?
六十一岁还能办什么保险	保险60岁能做什么
爸爸有案底可以给小孩买保险吗	爸爸注册表可以给孩子购买保险
保险合同的客体是什么	保险合同的目的是什么
商业人身保险与社会保险，社会保障二者之间到底是什么关系	商业保险和社会保险,社会保障两者之间是什么关系
欠了信用卡几年了,办意外险有影响吗	伤亡欠信用卡数年,有影响力的
保险退订后保险金多长时间返还	多长时间后保险退订保险回报呢
强制保险帖丢了不在本省能补办吗	强制保险失去的不是省可以补办
公众责任保险范围包括广告牌吗	公众责任保险涵盖了广告牌
个人房屋能办保险吗	个人住房保险
重大疾病日额保险包括哪些内容	什么是重大疾病,额保险包括什么
财产保险和人身保险有哪些不同	不同的财产保险和人身保险是什么
六级伤残可否购买保险	六级伤残可以买保险
厦*市在建工程前期需办理什么保险	大厦*城市建设项目必须完成早期的保险
香港保险和大*保险的区别详解	香港保险和保险的区别大*解释
保单贷款有哪些办理程序	政策贷款程序是什么
佛山汽车可以在珠*买交强险吗	佛山汽车可以在珠*购买保险
平安车险，被保险人和保险人有什么区别	平安保险,投保人和保险人之间的区别
天津汽车保险可以在廊*代理吗	天津汽车保险代理人在玄关*
办保险需要提供身份证和银行卡照片吗	保险需要提供照片的身份证和银行卡
中邮保险过了犹豫期能退保吗	邮政保险在犹豫期内可以投降
广*买的新华保险是否可在南*办理理赔	在南*宽*可以买新华保险处理索赔
六十一岁还能办保险吗	60岁的也可以做保险
购买美*留学生保险需要什么资料	买保险*学生需要什么信息
昆*车可以在广*买保险和理赔吗	昆士兰宽* *车可以买保险和索赔
苏*的车险在安*可以交吗	苏*安*可以提供汽车保险
我们家的车辆强制险被小孩撕烂了有没有什么办法补办	车辆强制保险在我们的房子已经被孩子们有什么方法来填补
在徐*买的车险在苏*可以用吗	在徐*购买汽车保险可以使用su *
乘坐阿联酋航空如何买保险？	在阿拉伯联合酋长国航空公司如何买保险吗?
汽车强制险交重了交两份儿那个退分怎么退呀	汽车强制保险支付重交两个很多点回来怎么回来
福*莆*人可以在孝感买保险吗	实现f * *可以在孝感人购买保险
太平洋车险商业险保单生效不到三天能退吗?	太平洋保险业务风险政策生效在不到三天回来?
不计免赔险的解释和含义？第三者责任险的解释和含义？	不管特许经营风险的解释和意义?
没有户口能给孩子上学平险吗	绝对不能给孩子上学ping的风险
分红保险交了四年如何退保	分红保险支付四年如何投降
意外医疗保险在外地住院可不可以报销	意外医疗保险在医院可以报销
是不是办任何保险都要身份证原件	如果任何保险id
交强险在确认赔付金额后,必须在多少日内进行赔付	保险赔偿金额确认后,必须在多少天内赔偿
汽车保险人应履行的义务有哪些？	汽车保险公司应当履行的义务有哪些?
邮政存款变保单犹豫期内怎样退保	邮政储蓄犹豫地改变政策时期如何投降
正德龙盛保险可以异地退保吗	卡尔德隆是持有保险可以是不同的投降
货车超载超速百分之五十出事故后保险公司如何理赔	超速行驶的卡车超载百分之五十事故保险公司如何索赔
平安保险划痕都有哪些轮胎划痕报废算不算	平安保险(Ping an insurance)划痕的废轮胎划痕
合肥新华保险怎么退保险	合肥新华保险如何退款
电话车险和普通车险有什么不同,区别是什么?	电话车险和普通汽车保险有什么区别,有什么区别?
50岁的人买了保险不愿意做检查能退保吗	50人购买保险可以不愿意做检查投降
车辆受损险含车辆玻璃保险吗?	车辆损失保险包括车辆玻璃保险吗?
第三者责任保险能否先赔付被保险人	第三方责任保险将支付被保险人
苏州车在合*怎么买交强险	苏州汽车*如何买保险
购买异地车险时，当出险后，和本地车险待遇有区别吗？	当购买不同的汽车保险,或者摆脱危险时,和当地的汽车保险利益有区别吗?
车辆被盗怎么办没交盗抢险保险公司赔吗	被盗车辆不被盗保险公司赔偿
汽车保险类型包括什么	汽车保险的类型
如果买完保险在犹豫期退保的话，本金要几天能返到手里？	如果买了保险后投降的犹豫期,几天可以回到校长的手吗?
投资连接型保险理财的犹豫期是什么意思	投资连接类型保险财务管理的犹豫期是什么意思
家人得重病,失去劳动能力,该买什么保险	这个家庭非常恶心,丧失劳动能力,购买保险
车子放路边被剐伤了保险会理培吗	汽车将路边的事故伤害保险的家具文化
大*人在美*开车要上什么保险?	大* *在美国开车什么保险?
办签证的航空意外保险怎么办	航空意外保险签证
航空保险再保险是出于什么目的	航空保险再保险是什么目的
合*二手车保险费怎么计算	*使用汽车保险费是如何计算的
申请保单贷款要具备哪些条件?	申请贷款的政策有什么条件?
社保跟商业保险的区别在哪？有了社保还需要买商业保险不？	在哪里社保和商业保险的区别?
保障型保险和养老型保险的区别	不同类型保障保险和养老保险
贵*车牌可以在苏*买保险吗	你在苏* *板可以购买保险
退保险用临时身份证行吗	退还保险临时身份证
保险合同没签可以退吗	保险合同不能签署并返回
用临时身份证可以办理车辆保险吗	临时身份证可以处理车辆保险
第三次续保怎么算第一年出险两次第二年无出险	第三次更新如何计算两相两年没有的年薪或摆脱危险
平安商业险可以申请垫付吗？要如何申请？	和平商业风险,可以申请付款?
两份不同公司的交强险车辆出险后可以同时陪付吗	两个不同的公司支付保险车辆后或危险,可以陪在同一时间
车辆强制保险标志被别人偷了怎么办？	车辆强制保险马克被盗吗?
什么是离岸豁免？	什么是离岸豁免?
工人没有工作证能不能办雇主责任险	工人没有工作许可证可以做雇主责任保险
商业险不计免赔可以单办么	无论单能做特许经营商业风险
八十四岁能否在成都平安保险公司买人身意外险?	八十四岁可以买人身保险在成都平安保险公司吗?
商业少儿保险是不管在什么地方都可以报的吗	商业保险的儿童无论在哪里可以报价
青岛车牌能在菏*买强制险吗	青岛板块可以买在菏*强制保险
保险十五日生效怎么回事	影响保险十五日怎么回事
倒车把下车人员撞伤用交强险可以理赔吗	后退的人员可以用保险索赔疙瘩
车辆全险必须在落户本地办理吗	车辆必须在定居在当地的一切险
个人账户资金损失险可以买吗？	个人帐户资本损失危险能买到什么?
食品安全责任保险算是产品责任保险吗？	食品安全责任保险产品责任保险吗?
赔别人的车维修费，属于第三者险里的内容吗	弥补别人的汽车保养,属于第三方保险的内容
54岁农村户口妇女可以买养老保险吗	54岁的妇女农村户口可以买养老保险
怎么为配偶买保险,为配偶买保险的注意事项是什么?	保险的配偶如何注意配偶保险是什么?
公证过的保险，可以重新变更吗	公证的保险,可以再次改变
强制保险过期40天罚款吗	强制保险过期40天好
保险公司如何赔偿受害人的经济损失	如何补偿经济损失的保险公司吗
补办购置税只需要带车辆行驶证吗	购买税只需要把车辆注册登记
个人意外保险与人身意外险有什么区别	之间的区别是什么个人人身意外伤害保险和人身保险
如果第三者责任险是5####而此次事故损失5###保险公司能全陪吗	如果第三方责任保险是5 # # # #和5 # # #事故损失的保险公司都可以陪伴
想在富德生命人寿保险入份保险，都需要办理哪些手续？	要在富尔德的人寿保险人寿保险,需要办理什么手续吗?
人寿保险防癌受保需达到什么条件	人寿保险与癌症BaoXu达到什么条件
江*车牌可以异地买保险吗	江*车牌可以不同的购买保险
银行办理的保险犹豫期能马上退款吗	银行办理保险犹豫期立即退款
保险公司不退保怎么办	保险公司不投降
强制险伤人责任划分后怎样赔偿	责任强制保险削减后如何补偿
7座车必须交什么保险才可以行驶	7必须支付保险可以开什么车
户口在梅*,东*买商业保险,可以吗	户口在* *东买商业保险,是好的
补办强制险标志当天能拿吗	强制保险标志着天
强制险赔医疗费还能赔物品费吗	强制保险缴纳医疗还可以补偿货物费用
保险买交强险后可加其他险种吗	保险购买保险后可以添加其他风险
产品责任保险和产品保证保险的区别	产品责任保险和保证保险的区别
办理人寿保险要用户口本原件吗	办理人寿保险使用户口本原件
土地种植保险属于商业险吗?	土地种植保险属于商业风险?
电梯维修保养工种属第几类保险承保？	电梯维修工作属于哪一种保险?
无证，醉酒驾驶朋友的机动车发生交通事故造成一人死亡，强制险理赔吗	没有许可,醉酒驾驶的朋友的机动车交通事故造成一人死亡,强制保险索赔
强制险超过二十天续保需要身份证吗	强制保险超过二十天更新后需要身份证
车辆按揭保险一定要在购车所在买吗	汽车抵押贷款保险必须去买的地方
购买重大疾病保险有保险发票吗	重大疾病保险和保险发票
保险拿不出来能不能报挂失	保险可以不出来挂失吗
在犹豫期内不能全额退保吗	在犹豫期内不能完全投降
车险可以异地续保吗?	汽车保险可以在更新吗?
幼儿园办理孩子意外伤害险都需要什么证件	幼儿园儿童意外伤害保险证书所需要的东西
邮政储蓄银行买的保险可以冻结吗?	邮政储蓄银行购买保险可以冻结吗?
信用保证保险和一般财产保险的区别有哪些？	信用保证保险和财产保险的区别?
非营运车辆能否办货物保险	车辆的操作可以做货物保险
退保还要申请吗	放弃申请
平安保险怎样可以全额退保	平安,如何全面投降
买了养老保险后继承人的名字可以改吗	继承人的名字可以改变后买了养老保险
刚过犹豫期两天可以退保吗？	后两天犹豫期可以投降?
违反交通法21条,商业险第三责任险赔吗	违反交通法规21日商业保险责任第三补偿
买保险一个多月后想退保该怎么办	一个多月后购买保险投降我应该做些什么
安*合*市的车牌在安*省*和*能买保险吗	安* *城市板块安*和* *省可以购买保险
离婚了买的保险咋办？受益人是彼此，	离婚,买保险吗?
有买保险行使证过期怎么处罚	必须购买保险行使处罚卡过期
亳*牌照的客车可以只买交强险吗	推荐她的*执照教练只能购买保险
汽车保险合同的基本事项包括哪些内容？	包括基本的汽车保险合同?
保险人与保险经纪人的区别	保险人与保险经纪人的区别
驾驶摩托车撞墙了,保险公司负责任吗?	驾驶摩托车撞到墙,保险公司负责吗?
重疾险不能做主险,必须跟寿险或者意外险做附加险吗?	严重疾病不能决策风险,必须额外风险生活或伤亡吗?
江*可以在四*续车险吗	江四* *可以延长汽车保险
意外伤害保险怎么买划算，意外伤害保险有哪些保障	如何购买讨价还价,意外伤害保险意外伤害保险有什么安全
保单还在核保期，要退保怎么办	政策仍在承销期,想投降
车辆的商业保险是保什么?第三者伤或亡,商业保险是否赔偿？	汽车的商业保险是确认?
买香*的保险需不需要考虑汇率风险？	买保险甜*需要考虑汇率风险?
对方只有交强险把人撞伤不够赔怎么办	彼此只有让受伤的人足够的补偿
异地出险是否要到当地保险公司才好报	不同的地面还是摆脱危险向当地保险公司支付
在平安保险上保险有保单可以贷款吗	在平安保险(ping an insurance)贷款的政策
新车无牌,未带交强险,未带驾照怎样处理	新车无证,没有保险,如何处理没有驾照
保险能否异地理赔?	保险可以长途索赔?
车辆停在自家院坝因大雨围墙倒下砸伤车辆损失保险是否该赔	车停在家里,因为大雨冲刷墙部分车辆保险应该补偿
香*保险主要有哪些险种？	保险的主要险种甜*是什么?
行驶证原件和保险原件丢失怎么办	原车辆许可证和保险损失该做什么
44岁的人上什么保险好?	什么是好的保险,44人?
车的商业三责险包括不计免赔吗?	三个主要风险包括不包括特许经营汽车业务?
没有强制险第三者包括务工费吗	没有第三方的强制保险包括农民工
香*养老保险有哪些优势?大陆人如何购买香*保险?	甜*养老保险的好处是什么?
保险保单承保生效两天能退保吗算犹豫期吗	保险单生效两天你能放弃犹豫期
26岁该如何选择一份合适的保险?	26日,如何选择一个合适的保险吗?
交强险属于强卖行为吗？违反消费法吗？	保险属于强卖行为?
没有身份证可以买平安保险吗?	没有身份证可以买保险吗?
社会保险与商业保险的区别是什么？	社会保险和商业保险的区别是什么?
商业险快到期不去交在有效期内出的车祸还能报吗	业务风险几乎是不进入事故可以报价的有效期
在香*购买了保险，投保人可以解除保险合同吗？	在甜*买了保险,投保人可以解除保险合同?
太平保险公司的分红险是以保费为分红基数吗?	太平保险公司的分红保险是基于分红的溢价基础?
德*短期留学的保险如何办理?	如何处理德*短期留学保险吗?
空调装配工意外险属于几类职业	空调伤亡属于几类专业
香*的重疾险与内地买的重疾险是否冲突？	甜*重疾病风险与内地买重疾病风险冲突吗?
美*暑期科研需要买什么保险	*夏季研究什么需要买保险
贷款保险费一定要交吗	贷款保险支付
车辆异地年检申请书办理需要多久	车辆年检申请表以外的处理需要多长时间
新货车头年能不能在异地买三责任险	新范第一可以买三个责任保险在其他城市
意外保险误工费是按工资打折算是怎么算	意外保险支付工资损失的折扣是如何计算的
自己发生车祸意外保险报销吗？报销流程需提供什么资料？	他的车祸事故保险报销吗?
安邦保险怎样办理退保	如何应对退保业务保险吗
买了一份意外保险,在国外受伤可以报销吗	买了意外保险,伤害可以报销
如果买了车没有开也要每年都交强险与车船税吗？	如果我买了车也没想保险和车辆税收每年吗?
不交购置税怎么办理	不付税如何处理
赣*车牌在深*买的交强险回赣能否可以年检。	江西*深*车牌可以买保险江西年检。
人身意外伤害保险纯保险费率的计算依据是什么	纯人身意外伤害保险费计算的基础是什么
未满十八岁的人办人身意外险要父母的身份证和银行卡吗	18岁的人做个人保险的身份证和银行卡,你的父母
第三者责任险不计免赔要按承担责任赔偿吗	第三方责任保险无论承担赔偿责任
办理人保无忧一生需要哪些手续	需要什么手续处理危险,安全的生活
澳*海外留学生保险到底能保什么?	澳大利亚*保险为外国学生继续什么?
驾驶证在保险公司登记多了有影响吗?	驾照在保险公司登记更具影响力?
检车，上牌和车险是一天，还用先买车险吗？	检查汽车汽车牌照和保险是一天,还用买汽车保险吗?
上午在银行买了富德生命保险下午可以去退保么	上午在银行买了富尔德人寿保险可能下午投降
强制险过期几天,第三责任险有包可以赔偿吗	强制保险过期几天,第三包可以补偿责任保险
保险公司对于意外身亡险给予赔付之后发现有骗保嫌疑会怎么处理？	保险公司的意外死亡保险待遇后发现涉嫌保险诈骗会如何处理?
监制保单与电子保单的区别	监管政策的区别和电子保单
交通事故三年未处理强险还能报吗	交通事故三年未办理强有力的风险也将引用
被骄车撞成右膀肱骨粉碎性骨折保守治疗怎么向车主和他的保险公司索赔	被车撞了右腿肱骨粉碎性骨折保守治疗如何主人和他的保险公司索赔
在山*省*汾*汾*县的平安保险公司可以退保险吗	忿忿的山* * * *省县平安保险公司可以退还保险
人保人身保险报销都需要什么手续	保护人身保险报销过程所需要的东西
返本型保险获取赔偿后可以再投保吗	回到这个类型的保险可以覆盖后再得到补偿
淘宝买到意外险航班取消了会自动退款吗	淘宝买伤亡航班取消自动退款
农村平房可以报中*人寿保险家庭财产险吗	*人寿保险在农村平房可以提交给家庭财产
中*人民财产保险可以办理摩托车交强险么？	*在人民保险(财产)可以处理摩托车保险吗?
财产保险与人身保险的区别有哪些	之间的区别是什么财产保险和人寿保险吗
保单失效怎么退保	贷款保单失效
中*保险公司哪家强？	*哪个保险公司的?
拒收险包括在一切险里吗	拒绝风险包括在一切险
头部毛细血管出血保险公司赔偿保险费吗	头部毛细血管出血保险费
住院自己申请岀院能报保险吗?	他们的应用程序文件一个法院将住院保险报价?
[平安车险]的网上续保、电话续保、4S店续保，哪样最好？	平安汽车保险在线更新,电话更新,4 s店更新,哪个是最好的?
机动车第三者险可以报停么	机动车第三者责任保险申请暂停
骑摩托车置人受轻伤交强险能快速理赔吗	骑摩托车的人受轻伤保险可以快速索赔
在单位内倒车伤人保险公司报不报	本单位伤害保险公司报告
车险中自己责任造成马路烂了可以赔吗	他的责任造成的道路汽车保险可以补偿不利
阳光保险稳赢人生的退保如何办理	阳光保险担保贷款在生活中如何处理
伤残鉴定10级,三者险只买了20万，保险公司能全赔吗？	伤残鉴定10级,三个保险买了只有200000,保险公司可以完全补偿?
车子出了四次险，第二年还能保全额不计免赔吗	第二年的汽车的四个风险,并保持完整不包括特许经营
想保单贷款但被距了一次了该怎么办	想政策贷款,但我应该做些什么
如何购买申请申根签证时需要的3W欧元以上的保险？	如何购买申请申根签证时需要超过3 w欧元保险吗?
商业险发票能当保单用吗?	商业保险可以发票当政策?
复合保险规划流程的具体步骤有	有规划过程中的步骤综合保险
开车时被别的车刮了对方溜掉了能报保险吗？	开车时被另一辆车的其他滑动可以报保险?
车辆造事对方死亡负主要责任没有准驾证保险公司是否理陪交强险	车辆建造东西对方主要负责死亡不伴随保险保险公司是否驾驶执照
气囊冲破坐垫坐垫保险公司会赔吗?	安全气囊的座垫保险公司会赔偿吗?
对方保险公司拒赔,我可以打保监局电话投诉吗标签：法律	你的保险公司拒赔,我可以保监局电话投诉,请标记:法律
交通事故中一死一伤，保险公司会理赔死亡的这方吗？	另一个在事故中受伤,保险公司会要求的死亡吗?
车损必须在指定的维修点修才赔全额吗	CheSun必须在指定维修点进行补偿
汽车购置税属于机动车第三者责任险赔偿范围内吗？	汽车属于机动车第三者责任保险赔偿的范围?
十几万左右的车有必要买划痕险吗?	十个左右的挠汽车需要买保险吗?
保险交到期限了,用到保险公司办手续吗?	保险期限,用保险公司手续吗?
太平洋车险，虚拟指定驾驶员跟实体驾驶员有什么区别，保单怎么看？	太平洋保险、虚拟驱动程序与实体之间的区别是什么指定的司机,你认为什么政策?
给三岁孩子买保险没户口本怎么办理	购买保险并没有如何实施三岁的孩子
先报了商业保险就不能报新农合了吗？	在第一个商业保险农民不能提交新的吗?
交通事故保险公司赔付伤者的误工费是按照什么赔付的?	交通事故保险公司赔偿受伤的工资损失是根据付款?
养老保险办理指南个人如何办理养老保险	养老保险办理指南如何处理个人的养老保险
行驶证过期能办保险吗？	能车辆许可证到期保险?
保险公司合同违法吗	保险公司合同法
营运车申请保险代位赔偿的条件	保险代位赔偿的条件操作车辆应用程序
车辆户口在新密，在洛*买的保险，能在郑*理赔吗？	车辆在新的户口,在洛杉矶购买保险,在郑*索赔吗?
办理交通强制险报销，需要什么证件	处理交通强制保险报销,需要什么证件
构不成住院条件的车祸需要赔付精神损失费误工费营养费护理费吗	没有医院交通事故赔偿赔偿条件需要钱支付这些费用
本人无让驾驶自投保的车出了交通事故保险公司还负责吗？	我没有驾驶汽车的交通事故还负责保险公司吗?
身份证过期可以办理养老保险吗	身份证过期了可以处理养老保险
退保，需要哪些手续	投降,需要什么手续
车辆定损维修报销保险双方都要提供发票吗	汽车保养费用补偿保险双方提供发票
交通一事故同等责任保险公司怎么陪全保	交通事故同等责任和所有保险公司的风险
机动车保险合同由哪几部分组成	机动车辆保险合同的几部分
重复保险中保险人的保险给付义务应怎样承担	双保险保险人保险支付义务应该如何玩
没有底单可以办摩托车险吗	没有底单可以做摩托车的风险
理赔必须要有维修清单吗？只有发票可以吗	要求必须有一个维修单吗?
车险发票被保险人身份证号码无法提供影响报销吗	汽车保险被保险人身份证号码无法提供发票报销的影响力
保第三者险都要什么步骤	哪些步骤覆盖第三方风险
人人保生效了可以申请退保吗	任何人确认效果,可以申请贷款
改变轮胎型号违法吗、发生事故保险公司会拒赔吗	改变轮胎模型是非法的,意外保险公司会拒赔
雇主责任险可否在税前扣除	雇主责任保险可以在税前扣除
车丢了除盗抢险以外的险种能退吗?	失去了我的汽车保险除了被盗可以退款吗?
车险理赔保险公司不肯赔付怎么样才能保证消费者权益？	如何汽车保险索赔保险公司拒绝支付,以确保消费者的权益?
请问，单位保了雇主责任险，在这期间，员工生病死亡了，有赔偿金吗？	单位,请保护雇主责任保险,在这段时间里,员工生病死了,有补偿吗?
60元的学勤险最高赔偿是多少！我侄儿在家溺水身亡！请问60元的保险费应该赔偿多少钱？	60元学习经常是多少最高风险补偿!
太平洋分红保险是否可以转户?	太平洋保险分红ZhuanHu吗?
强制险过户都是需要什么证件？是不是过户方去就可以了？	强制保险转移需要什么证件吗?
中*人民财产保险车险一年可以报几次	*在中国人民财产保险汽车保险可以报几次一年
我老公车祸身亡,户口没注销,保险公司的意外保险钱能拿到吗	我的丈夫被杀,户口没有取消,保险公司的意外保险可以得到钱
车辆过户了,车险没有过户影响年检吗	郊游,汽车保险没有转移影响年检
发生交通事故对方是主要责任,是否还能走保险，	另一种是交通事故的主要责任,是否也可以走保险,
手指少一节算是意外伤残吗?意外伤残保险管用吗?	手指部分不太意外残疾?
违反了保证,保险合同就是失效吗	违反担保,保险合同是一种失败
互联网保险真的比传统保险有优势吗？	互联网保险真的比传统保险有优势吗?
汽车第三者责任险出交通事故可以报保险吗	车辆交通事故的第三方责任保险可以报保险
车祸，孩子伤残九级，学平险和互助金可以报销吗	禁用九年级,交通事故,孩子学习平风险和相互黄金可以报销
交了三年的养老保险可以退吗	移交三年的养老保险可以退款
劳动保险费是什么意思呢？	劳动保险费的意义是什么?
车险一年可以报销几次	汽车保险可以报销一年几次
车保险拒赔投诉保监会投诉有用吗	汽车保险拒赔保监会投诉有用
部分领取和保单贷款是什么意思	零件图和政策贷款是什么意思
驾驶无检验无保险的车辆上路处罚是什么?	车辆驾驶没有检查没有保险的惩罚是什么?
车撞了对方肋骨骨折两根是不是该由保险公司来赔偿	被一辆车撞倒了另外两个肋骨骨折的由保险公司赔偿吗
喝了二两白酒,车祸保险公司礼赔吗	喝两白酒,事故保险公司赔偿
小私企买财产保险,倒闭后保险有陪保吗	小型私人公司的崩溃购买财产保险,保险和保险
汽车行驶证还在办理车险可以保吗	机动车牌照仍应对汽车保险可以保护
交强险受伤住院构不成伤残能赔多少	没有残疾可以补偿多少保险受伤住院
相比传统车险，永*电话车险和网上车险有什么不同	与传统的汽车保险相比,总是电话车险和网上汽车保险有什么区别
买的三者加不计免赔三十万是要按承担责任赔偿吗	无论球队在三十万年买了三是承担赔偿责任
中*人*泰福禄寿喜分红保险是什么险	* *泰铁ShouXi分红保险是风险
出了交通事故报警了，车主的车子都买保险了，人受伤了，保险公司怎么赔偿伤者，还要什么手续吗？	交通事故报警,车的主人去买保险,受伤,保险公司如何补偿受伤,但也什么手续吗?
什么是地下保单，地下保单一定无效吗？	地下保单,地下政策必须是空白?
不记免赔盗抢险是怎样赔偿的	不记得特许被盗赔偿
除了公司帮忙交的养老保险，个人还能去保险公司买养老保险吗？	除了公司来帮助支付养老保险,个人可以买养老保险保险公司?
开车撞人导致脚残废,买了30万第三者,保险会赔偿吗?	开车到一个脚残废,买了300000,第三方保险赔偿?
我老公是长子，因为结婚分了户口，他爸爸意外死亡，他有保险公司的赔偿吗	我的丈夫是长子,因为结婚了户口,他的父亲意外死亡,他是保险公司的赔偿
人寿保险金鼎富贵两全保险分红型每年分红会打到帐户上吗	人寿保险养老保险丁繁荣每年分红奖金将在账户上
重大事故司机不是大车证保险公司赔偿吗	重大事故司机不车卡保险
什么是保险合同的默认条款？	保险合同的违约条款是什么?
平安车险全限我全部责任30万商业限赔对方多少维修费	平安保险(Ping an insurance)限制我对300000年的全部责任赔偿对方多少维修业务
保险费的年汇率是什么	汇率的保险费是什么
同责时我的车辆损失费保险费怎么保险赔偿	负责我的车辆损失保险保险索赔
事故不知情开车走了保险公司理赔吗	事故不是开保险公司索赔
不小心触电死了,意外保险赔偿吗	不小心触电死亡,事故赔偿
车险索赔单证（7）：火灾事故需提供哪些索赔单证	汽车保险索赔文件(7):需要提供火灾事故索赔文件
意外保险赔偿所需材料必须是原件吗	意外保险赔偿所需的材料必须是原件
延误险的延误时间按什么时间算起？	通过时间延迟延迟时间的风险是什么?
职场的人有必要买大病保险吗？	人们在工作场所有必要购买大病保险吗?
车险定损后可以不在定损点维修吗	汽车保险费用不能维修费用后点。
多大的孩子可以买儿童意外保险卡？	孩子们可以买多少孩子意外保险卡吗?
保险能帮助我们解决什么问题？	保险可以帮助我们解决这个问题吗?
如何了解中*平安保险平安福怎么样？	如何理解和平f *保险吗?
我想问一下要换投保人都用什么手续呀原来是我老公的现在换我的投保人	我想要求投保人的过程变成了我现在的丈夫在我的申请人
身故保险金受益人是什么意思	死亡保险受益人是什么意思
车子受损严重保险公司可以换新的吗	车严重受损可以改变一个新的保险公司
58岁还能买防癌险吗？	58岁的也可以买得癌症的风险吗?
刚买的保险不到十天～还没给保单！请问想要退保的话应该怎么办？但是有短信发给我一个合同号！	刚买了不到十天的保险~没给政策!
保险有哪些缴纳保费的方式？	有什么办法支付保费的保险?
平安保险第三者责任险内容	平安保险(Ping an insurance)的第三方责任保险
一百万的三责险赔偿范围	一百万年的三个主要风险补偿范围
买重疾保险需体检吗？	购买大病保险需要体检吗?
，保险是真的吗？寿险包括那些？	,保险是真的吗?
车险保险卡怎么补办需要那些证件	汽车保险卡片如何填补需要这些文档
住宅责任险购买有没有什么技巧？	房地产责任保险买什么技能?
保险责任和保险风险的区别	保险责任和保险风险的区别
定期寿险可以单独上吗？不要附加险那种	定期寿险可以单独吗?
儿童教育储蓄险是什么险种有什么优势？	孩子的教育储蓄保险类别有什么优势?
购买新车保险办证需要户口本吗	买一辆新车保险证书需要户口本
买了大瑞鑫还要买重疾险方面的保险吗	买了一个大瑞鑫有严重疾病风险的保险
交强险可以加不记免赔车险吗	在车险的保险可以不记得连锁店
意外伤害保险怎么报销	意外伤害保险报销
刑释人员能买商业保险吗?	康复人员购买商业保险吗?
车险4s店买了一半外面补买第三者保险可以吗	汽车保险4 s店买一半维修店外第三方保险
关于保险保单万能险这一险种怎么解释？	这个险种万能保险风险如何解释?
如果个人想办保险是社保好还是商业险好啊	如果人们想要做的好或商业风险的社会安全保险就可以了
投保两年后不想要了可以变更险种吗?	两年后,不希望可以改变保险吗?
29岁人想买份保障比较全面的保险，买哪个险种合适	29人想买一个安全综合保险,这是种植
商业保险怎么规划好？	商业保险计划吗?
买养老之类的保险，哪种比较好	买养老保险等,哪个更好
车买三责险都包裹什么赔偿	汽车三个主要风险补偿方案
我今年48周岁想买中*人寿养老险哪种比较好	我48岁想买*生活养老保险哪个更好
建筑工程团体险怎样交保费，有些什么保险责任	建筑工程集团保险如何缴纳保费,保险责任
在保险行业中，啥叫保险人，被保险人，投保人	在保险行业,所谓的保险人,被保险人与投保人
防癌保险一年多少钱	癌症保险一年多少钱
如何理解保险合同中的最大诚信原则	如何理解最大诚信原则在保险合同
意外保险一年交多少钱？	意外保险支付多少钱一年?
如何购买人身保险	如何购买保险
智慧星是终身险吗？	智慧是一个终生的风险?
旅游意外保险的赔偿范围包括哪些	旅游意外保险,包括补偿程度
39岁的人适合买新华保险的哪个险种	39,适合买新华保险
私自乱停放车辆丢失保险公司可否赔偿吗	秘密无序停放车辆保险公司可以弥补失去的
意外伤害险进行投保时应如何选?	当意外伤害保险应该如何选择?
部队随军家属需要买地方商业保险吗	部队军队家庭需要购买商业保险
补办太平洋车险强险贴需要什么证件	补办强劲太平洋保险风险岗位需要什么证件
车险保证金什么时候给	汽车保险什么时候给定金
中*人寿老年人保险哪种好	*生活中老年人保险是很好的
给酒店上保险，属于什么险种?	种植的是什么酒店保险,属于?
感觉平安车险说的先赔付，再修车挺吸引人的，有什么限制条件吗？	首先感觉安全的汽车保险支付,然后修复很有吸引力,限制是什么?
车险三者险中，是否包含营养费？	三个汽车保险的风险,包括这些付款吗?
四十几岁一年交三千到五千保费买哪种保险好	在他40年代奖金三千-五千零一年买什么样的保险
法*旅游怎么买签证保险？	方法*旅游签证如何买保险吗?
网销车险项目描述及包含的内容	网上汽车保险项目描述和内容
保险利益是什么?与投保有什么关系?	保险利益是什么?
缴费年限是什么？	缴费年限是多少?
侏儒症可不可以交商业保险	侏儒症可以缴纳商业保险
驾驶员适合哪种意外保险？	司机适合什么样的意外保险?
我今年40岁，女性，适合买什么险种的保险	我今年40岁,女性,适合买什么保险
买了人寿保险没过犹豫期能全额退款吗	买了人寿保险可以毫不犹豫地发出全额退款
企业财产保险的责任范围是什么？	企业财产保险责任范围是什么?
建工一切险三者费率保额怎么确定	确定的工程一切险三种率范围
投保人可以重复保险吗?	投保人可以重复保险吗?
保险:客户带病投保重大疾病,后果是什么?	保险:客户重大疾病保险,尽管是什么?
给老公投保重大疾病保险，不知道哪种重大疾病保险好	给丈夫重大疾病保险,不知道什么样的重大疾病保险
想买保险，关于商业医疗保险，请问我适合买哪种医疗保险	想买保险,商业医疗保险,我可以买什么样的健康保险
想买保险了，请问商业保险有哪些	有什么想买保险,商业保险,好吗
保险公司负责赔偿的海上费用有哪些?	保险公司负责赔偿成本的海?
老年人买招商信诺大病险适合吗？	买投资信诺大渗流路径适合老人吗?
手指被人用镰刀割断,是几级伤,可以报意外险吗	手指被切镰状,几级,可以报保险
如何投保意外保险	如何保险事故保险吗
在网上可通过哪些渠道购买保险?可买到哪些险种?	在互联网上通过什么渠道购买保险吗?
划痕险和自燃险不计免赔整体购买是什么意思	尼克风险和自燃风险无论特许经营在整个购买是什么意思
意外保险人死了干嘛还要赔那么多钱	保险事故死亡为什么花这么多钱
交通事故后一星期保险公司能索赔吗？	一周后交通事故保险公司索赔吗?
天安财产保险在犹豫期退保几天能到账	天安财产保险在犹豫期投降几天可以到
阳光网上车险有哪些专属服务啊	阳光网上汽车保险是专属服务
车险中的车船税是否属于商业险的范围	汽车保险在车上是否属于商业风险的范围
小孩子适合买哪种重疾险，有没有好的产品介绍	孩子买什么样的重大疾病保险,有一个好的产品介绍
保险公司赔受害人,受害家人多和少怎么赔	保险公司赔偿受害者,受害者的家庭越来越少如何补偿
怎样查自己的保单	如何检查你的保险政策
有年交2000块的重疾险吗	所以交2000块的沉重的疾病风险
本人现块50岁了,想老了领养老金,怎样交钱	本人块50岁,想老退休人员,如何赚钱
什么是香*保险，为什么要买保险？	甜*保险是什么,为什么要买保险?
保险公司拒赔或者免赔会通知被保险人吗，如果通知会以什么方式通知	保险公司拒赔或特许经营将通知被保险人,如果发现将以何种方式
招商信诺儿童险如何投保？	招商信诺孩子保险承保的风险如何?
保险公司的分红产品受法律保护保本吗?	保险公司的产品是受法律保护的分红收支平衡?
在人寿保险中35岁的人适合买什么险中	在人寿保险中,35人买什么险
给儿童买保险有哪些注意事项	为孩子购买保险注意事项
交通事故多长时间能得到保险公司的赔偿	需要多长时间交通事故保险公司的赔偿
柜台险和电话险有哪些区别，都是什么	柜台和电话有什么区别,风险
三十多岁的人买平安保险，月收入8000，适合买哪种险种	超过30岁的人买平安保险,月收入8000,适合买什么样的保险
机动车交强险的投保义务人是谁？法理是什么？	机动车辆保险在保险代理人是谁?
没有田地居民户口四十岁可以买养老金吗	没有字段居民占四十岁能退休
分红保险是在年底分红吗	分红保险是在今年年底分红
办理摩托车保险没有驾驶证行驶证可以办吗？	可以处理摩托车保险没有驾照登记办公室吗?
买了母子平安保险好久才能生效?	买了平安保险(ping an insurance)很长一段时间成为有效?
事故车辆报废期到了保险公司怎么偿	事故车辆BaoFeiQi向保险公司提出索赔
重大疾病保险保终身投保后得知肝炎去世可以理赔吗	重大疾病保险保护人寿保险,死后肝炎可以索赔
观察期内被保险人死亡,保险费给退吗	在观察期间被保险人死亡,退还保险费
五险一金的医疗保险和人身保险中的医疗保险区别	五项社会保险和住房公积金医疗保险医疗保险和人身保险的区别
太平洋保险中途能不能换险种	太平洋保险可以中途在报道
车辆单方面事故，保险公司理赔程序？	单方面交通事故,保险公司索赔手续?
新华保险买了后多久内可全额退款	新华保险买了在多久可以全额退款
q7擦刮了可以报划险吗	刮q7可以提交给中风风险
意外保险一年要交多少钱	意外保险每年应支付多少钱
车辆强制险赔偿范围	车辆强制保险赔偿范围
农村能买些什么保险？	农村可以买保险吗?
62岁可以办车辆购置税吗	62岁可以申请车辆购置税
保险买了有什么好处	买保险的好处是什么
5岁少儿重疾保险有哪些险种	有哪些类别的5岁儿童严重的疾病吗
啥是旅行社责任险	旅行社责任保险是什么
泰康保险怎么退保有损失吗	泰康人寿保险退保损失
如何买重疾保险，主要关注什么	如何购买大病保险,主要关注什么
招商信诺年金险领取方式是怎样的？	招商信诺年金保险是什么方式?
平安保险，有疾病能买吗	平安保险(Ping an insurance),疾病可以买
保险公司手续都填好啦、签字啦,理赔需要多久	保险公司手续,签署,理赔需要多长时间
8座小车人寿强制保险多少钱?	八个生命强制保险车多少钱?
太平人寿保险，不想要了，仍在犹豫期，怎么退保	太平人寿保险,不想,还在犹豫期内,如何投降
交强险与车上人员责任险哪一个优先	保险和责任保险的人员先上了车
分红保险中间被保人死亡会理陪吗	分红保险中被保险人死亡减少陪伴
异地参加新华防癌保险可以吗	长途可以参加新华保险癌症
领取身故保险金的材料丢失了可以补办吗	得到保险材料失去了可以补办
五险一金会下调吗	五种社会保险和住房公积金将减少
车辆保险包括什么险种	车辆保险包括哪些风险
保单没了,知道保单号,到期可以取吗	政策,不知道政策数量,成熟
保安公司不给员工买养老保险对不对只给买意外风险这合理吗	保安公司不为员工购买养老保险不仅购买事故风险是有意义的
飞机意外险怎么申请理赔,理赔流程是怎样的?	飞机事故如何索赔,索赔过程是什么?
被保险人是我，保险到期需要提供身份证吗	被保险人,保险到期需要提供身份证
只有第三责任险没交强险可以赔偿吗	只有第三责任保险可以补偿
社保半年没交了，是不起处于停缴状态？	没有缴纳社保半年,不是在停止支付?
社保十五年能领多少钱	十五年的社保将多少钱
农业保险需要什么手续	农业保险需要什么手续
意外伤害保险可以在外地买吗?	意外伤害保险可以买到其他地方吗?
个人交的养老费到八十岁能一次性领完	个人缴纳养老费到八十岁可以一次性完成
给6岁的孩子投保人寿*鑫两全保险怎么样	6岁的孩子生活*新养老保险投保
车辆停驶其机件致第三人损害保险公司如何赔偿	汽车停止第三部分保险公司如何弥补
买了太平洋意外险后半年意外摔伤致十级伤残能赔多少钱	买了之后在太平洋伤亡事故伤害到10类禁用可以补偿多少钱
各人交的社保、今年退休可以领到社保是休金	他们每一个人支付社保,你可以得到它从退休金是今年休黄金
车辆全保,驾驶证分被扣完发生车祸,保险公司要赔款吗	完全保险车辆,驾照分被拘留在交通事故后,保险公司支付
车辆赔偿除了维修费，折旧费怎么赔	车辆损失除了维护成本、折旧成本如何补偿
我三十八岁，交人寿保险鑫如意三年，每年两万，怎么领钱	我38岁,在人寿保险鑫财富三年,二万零一年,如何得到钱
保险理赔不满意起诉的个人还是保险公司	保险索赔不满意起诉个人或保险公司
什么是不计免赔险?不计免赔险的保障范围有哪些?	没有特许经营风险是什么?
内地居民可以购买香港保险吗	大陆居民可以在香港买保险
什么保险公司最可靠？	最可靠的保险公司是什么?
车停楼下（不是停车场）被挂，请问保险公司赔吗？	车在楼下(不是一个停车场)被挂,请问保险公司赔偿?
车险可以规定使用者吗？有什么好处？	汽车保险可以提供用户?
昆*积分入学自己购买的商业保险属于社会保险吗?	他*积分入学的自己购买商业保险属于社会保险?
开车撞了小孩全责小孩住院了小孩住院期间检查费保险公司赔偿吗	车撞了孩子只是孩子在医院住院保险检查
车辆报险维修时定损费低于修理费怎么办	车辆在维修费用风险费用低于修复
给小孩5岁买保险需要户口本吗	5岁儿童购买保险需要户口本
刚办的保险能退吗,不想找代理人能行吗	就可以做保险退款,不想找代理可以做它
车子商业保险赔付5000多算不算大事故	汽车超过5000商业保险索赔不是重大事故
车子被别人划了,买的全保可以赔钱吗?	车被划伤,可以买一切险亏损?
互联网保险推广平台需要到保*会申请吗	网络保险营销平台将需要保持*申请
事故中的对方车辆损伤算不算第三方责任险的赔付内容？	其他车辆伤害事故不是内容的第三方责任保险索赔?
农村合作医疗包含着意外险，在本市受伤了，是否给报销	农村合作医疗制度包含伤亡,受伤的在这个城市,是否报销
我刚买了新车办了不计免赔险，而人保在合同书上注明每次车险免赔300元，这办了不计免赔险有何意义？	我刚买了一辆新车,不包括特许经营风险,并保存在合同中指定每个汽车保险业务300元,这并没有特许经营风险有何意义?
保险交的年限长好不好	保险缴纳年限长的很好
银行卡的短信服务如何更换号码？	如何改变消息服务的号码卡吗?
没有医疗保险能办人身意外保险么	没有医疗保险人身意外保险
汽车丢失退保从丢车那天算还是从去办理那天算?	汽车失去了撤退的汽车仍然是需要解决的一天那一天?
由低血糖导致的意外伤害,保险公司可以报销吗	低血糖造成的意外伤害,保险公司报销
在外地发生车祸，车可以拿回了维修吗	在一场车祸,车子可以收回来修复
银行理财在犹豫期退保会不会恶意拖延犹豫期不退该怎么办?	银行金融舞台犹豫了投降恶意拖延犹豫不退款呢?
肇事逃逸使人重伤伤残8级.我起诉保险公司强制险赔偿多力	打了就跑的严重残疾8级。
怎样投诉保险公司	如何投诉保险公司
交强险理赔保险公司安全部医药费的百分之七十赔偿合理吗?	医疗保险索赔百分之七十的保险公司赔偿是合理的吗?
交通事故交强险中死亡伤残十一万里面包含精神损失和务工费吗？	死于交通事故保险禁用包含一百一十精神损失和工人?
请问在邮政储蓄买的国寿鸿丰两全保险(分红型)到期在哪领取?	对不起,王国的邮政储蓄购买养老保险ShouHongFeng(分红)由于接收在哪里?
倍保如意意外险理赔的内容	《纽约时报》的内容保护最好的伤亡索赔
富德生命人寿如意險犹豫期内撤销保险合同会全额退款吗	富尔德生活最好的人寿保险犹豫期内撤销保险合同将全额退款
鑫福年年，如果退保，在犹豫期外，可以全额退款吗	鑫福年复一年,如果投降,在犹豫期内,可以全额退款
三十七岁车祸九级伤残赔偿多少钱	9级伤残37岁的事故赔偿多少钱
异地买重大疾病保险能转回老家吗	在另一个地方购买重大疾病保险可以回头
车身停在小区被划痕，保险公司赔吗？	汽车停在村子里尼克,保险公司赔偿吗?
9级伤残没买保险企业赔多少?	9级伤残没有买保险公司赔偿吗?
癌症放疗在商业保险里属于手术赔偿范围之内吗?	癌症放射治疗在商业保险赔偿范围属于手术?
饮酒导致车祸保险公司给予理赔吗	喝酒导致交通事故保险公司索赔
六十五岁以上老人在工作时意外死亡，用人方应该承担什么样的责任	超过六十五岁的意外死亡,雇主应该承担什么责任
车险还没到期就买了第二年保险，这期间出了车损险需理赔，会影响到第三年的车险吗	买了第二年的保险汽车保险还没有到期,在此期间CDW称,将影响汽车保险的第三年
农村户口怎么买养老保险	农村户口买养老保险吗
女三十九农村户口在莒*劳*局买养老保险怎样买	女39农村户口在君安法律* *局购买养老保险如何购买
车险指定驾驶人,超过60岁,保额是否要增加	汽车保险指定的司机,60多岁,是否增加了额头
交通事故造成十级伤残交强险是保险公司一次给吗？	交通事故造成十级伤残保险的保险公司吗?
泰康金满仓两全保险分红型分红少吗	泰康养老保险金全部分红分红较少
骑电瓶车撞伤人。伤者的住院费用，能不能从意外险里赔偿的?	骑电瓶车疙瘩。
交强险是在哪一年哪月哪日正是在全国范围内实施	保险在哪一年哪月哪一天它是一个全国性的实现
办车险需要哪些证件？如何办理	真的需要什么证件吗?
在保险公司缴纳的医疗保险费用到期还退还吗	在保险公司支付医疗保险费用由于退款
饮酒过量造成的酒精中毒保险报销吗	喝太多酒精中毒引起的保险报销
人身意外伤害保险如何评定伤残？时间有期限吗？	如何评估禁用人身意外伤害保险吗?
保险有什么用	保险有什么用
交通事故,一次性赔偿由保险公司支付还是车主	交通事故,由保险公司或业主支付一次性补偿
中*人寿保险，保险合同签收当日可以办理退保吗	*在人寿保险中,保险合同签收当天处理保护撤退
泰康保险合同刚拿上想退,回执未签字,能退吗?	泰康人寿保险合同取想要返回,返回收据没有签字,你可以退款吗?
建行富德理财保险过了犹豫期2天还能全额退款吗	建行fuld犹豫期2天的金融保险也可以全额退款
车祸负全责.对方车辆维修的费用保险有赔吗	对汽车事故承担全部责任。
网上可以买到长期意外保险吗？	网上可以买意外保险很长一段时间吗?
车祸我小腿骨折,对方全责,花了10万多自己垫付钱,伤残10几,对方得赔偿多钱	车祸我小腿骨折,另一方只,花了100000多的钱支付他们的帐户,禁用10几个,另一方应支付多少钱
异地支取保险需要什么手续	撤军过程以外的保险
医保新政策异地医保怎么报	新的卫生政策不同的卫生保健
保险有哪些险种	有哪些类别
在三水买了房子可以办本地医保吗	在三水区买房子可以做当地报道
生育险到账有时间限制去取吗	有没有时间限制生育危险张吗
新*区失业金到哪部门办理。	新*地区失业部门处理。
领失业金期间医疗保险是职工医疗吗	初请失业金人数在职工医疗的医疗保险
什么是财产保险的核保	什么是财产保险承保
单位以变更单位名称为由拒交失业险合理吗	单位改名拒绝缴纳失业保险是合理的
新车出险一次金额不大第二年保险有影响吗	新车或摆脱危险的少量的第二年的保险生效
社会保障体系的总体框架是什么	社会保障体系的总体框架是什么
单位里所谓的五险一金。都是缴纳给保险公司吗？	所谓的五种社会保险和住房公积金单位之一。
退保时随便提供个账号就可以吗?	你可以提供一个帐户投降?
公司给办五险可以看到我的户籍资料么	公司要做五个保险可以看到我的户籍信息
自由职业交的社保可以开单位名称的发票吗	自由职业者缴纳社保可以打开发票单位名称
社保上交到单位，但单位没有上交怎么办	由于社会保障的单位,但是单位不支付
已经交养老保险的在就业还需要扣五险一金吗	已经缴纳养老保险和就业需要扣五种社会保险和住房公积金
中华保险理赔,伤残者应准备什么材料	中国的保险索赔,残疾人应该准备什么材料
生育金和工伤保险不交了可以退吗?	轴承黄金和不支付工伤保险退还?
我已经辞职了发现公司没给上生育险该怎么办	我辞去了工作已经发现,该公司没有生孩子危险我应该做些什么
没驾照可以买车么并上保险么	没有驾照是一辆车在姚明和保险
食品安全责任强制保险与食品安全责任保险是不是一样	食品安全责任强制保险和食品安全责任保险是一样的
女方没有工作男方的生育金报销吗	女人没有男人婴儿黄金报销工作
下岗了单位还收失业金也没发失业金哪？失业金是干什么用途的？	也下岗单位收到失业救济金也不发失业救济金吗?
单位半途中不给续交失业险怎么办	单位不给缴纳失业保险
养老保险从中卫转中宁怎么办理	养老保险转移的中后卫宁如何处理
异地医疗保险如何办理	如何处理不同的医疗保险吗
企业职工养老保险自己可以多缴吗	企业职工养老保险可以自己支付
赫赛订在宁*居民医保如何报销	赫赛汀如何成为一个更好的*居民医保报销吗
顺德失业保险手续齐全几天到帐	顺德失业保险手续齐全了几天的帐户
农村养老保险可以在网上支付吗	农村养老保险可以在网上支付
基本险与外来务工险的区别	基本的区别和外来风险
交通肇事罪负主要责任保险公司赔偿能按全责赔付吗	主要负责交通事故保险将支付按全部责任
在公司六年养老保险没给交主动离职还有什么补偿？	在六年的养老保险公司没有给/主动离开什么补偿?
新农村社保卡不见了。怎么报销	新农村社会保障卡不见了。
不缴五险的单位把工人回掉了有补贴吗	工人们不付五保险业务补贴后退
十五年前一次性缴纳社保算数吗	15年前支付社保数
闯红灯造成对方车辆受损,保险公司会陪吗?	红光损害对方车辆,保险公司将陪同吗?
出院医疗保险，保险公司转卡，可我想要现金可以吗	医院的医疗保险,保险公司卡,但我要现金
代位追偿结果对责任方有什么损失吗？他交的钱保险公司还给报销吗？	的代位追偿责任损失的结果吗?
基本保险金额是什么意思	基本保险金额是什么意思
女方生育险在产前一个月停止，可以用男方的报销吗	她一个月前停止生育风险,您可以使用还款的人
我己拿失业金后公司上班没交养老金辞退后公司是否要补偿养老金	我有失业救济金,公司工作不支付养老金解雇,公司是否补偿养老
生育保险报销资料由股长复审,审查什么	生育保险报销,审核,材料审核
公司未注册不签劳动合同不买社保能找劳动仲裁吗？	公司是注册不签订劳动合同可以不买社保劳动仲裁呢?
达到退休年龄但未交社保会有退休金吗	达到退休年龄但没有支付社会保障养老金
女方生育险在产前一个月停止,可以用男方的报销吗	她一个月前停止生育风险,您可以使用还款的人
我在厂里上班没辞职，又找了另外一个厂这样社保公积金还能交上去吗？	我在工厂工作不辞职,再找到另一个工厂,社保公积金还可以交吗?
买车购置税怎么算,我买1.8排22,78万应交多少	汽车税,如何计算我有多想买1.8行22,78应付
失业金没有身份证可以签到吗	失业救济金没有身份证登录
意外险在旅游时因骨质疏松症并发症骨折,保险公司理赔吗	伤亡旅游由于骨质疏松骨折并发症,保险公司索赔
五险一金是什么意思？五险一金要交多少年？	的意义是什么五个社会保险和住房公积金?
农村户口满60岁怎样一次性购买养老保险?	农村户口如何年满60岁一次性买养老保险吗?
强制险被别人买了,找不到别人该怎么办	强制保险被别人买走,找不到别人该做什么
刚买平安保险不久能全额退款吗	买保险很快全额退款
单位交的生育险生之前需要办理什么	单位缴纳生育险在出生之前,需要处理
自己有社保如何在公司里转正需要什么手续	他们有一个社会保障如何成为正式成员的公司需要什么手续
购买了工商银行双全福利保险可以退保吗	可以买两个工商银行福利保险投降吗
失业6个月后还可以办失业险吗	失业六个月后还可以申请失业保险
领失业金期间退休,失业金多发一个月,能不能退	初请失业金人数在退休、失业救济是一个月,不能回去
个体户主可以在别人的公司交社保金吗	个人业主可以在别人的公司缴纳社保
车辆出险后拒赔，第二次再次报案还能理赔吗？	车后拒赔或危险,第二个报告又可以索赔?
快速理赔后被保险人全责不赔付怎么办	快速调整后被保险人完全不支付
重大疾病保险到80岁如何办理返还手续	重大疾病保险的80岁高龄的如何处理手续的回报
社保单位交多少个人交多少个人交248元单位交多少？	社会保险单位缴纳个人单位支付个人缴纳248元人民币支付吗?
保险代理人的工作职责是什么?	保险代理人的工作是什么?
报了少儿互助还能报学平险吗?需要什么手续	在孩子们的合作也将平的风险?
老人给孙*买保险己交钱，一样有效证件都没提供，才一天，能退款吗	老人买了太阳*保险支付钱,没有提供有效证件,一天,你可以退款
保险合同不是投保人本人签字的，合同有效吗？	保险合同的签名不是投保人,合同有效吗?
辞职后还需可以继续交工商保险吗	辞职后还需要继续缴纳商业保险
宁*不交养老保险的60岁后还给补贴吗	*比60岁后支付养老保险补贴
工伤七级如果公司不干了,怎么赔我	工伤七如果公司辞职,如何补偿我
外来人员辞退后自己能不能交社保	局外人能辞职后缴纳社会安全
小*车一年未买保险怎么续保	每年多少*汽车没有买保险更新吗
父母年龄60岁以上河*农村户口未交过保险有什么养老保险种类可以交的吗	父母年龄超过60河*农村户口不支付保险什么类型的养老保险可以交付
员工拿到失业金后可以索讨单位补偿金么	员工获得失业救济金之后可以准确的单位赔偿
五险跨省可以从新交吗？	五个省可以从新加坡?
打工老板买集体保险工地发生意外受害着能拿到保险吗	为老板工作网站购买集体保险事故受害者可以得到保险
领完失业金交三个月生育险就生产了有生育补贴吗	领失业生育保险支付三个月后生产有生育补贴
货车有贷款，保险必须要在车队上吗？	卡车有贷款,保险必须在团队吗?
犹豫期内退保。申请书上面需要业务经理签字。可以代签吗	犹豫期投降。
在农行稀里糊涂的办了华夏保险犹豫期退保什么时候到账	在雾中中国保险犹豫地问题上的投降时到来
单位裁员后怎么办理失业保险?不能超过多长时间?	单位削减后如何应对失业保险吗?
在单位上班要多久生孩子才有生育补贴	要多长时间到达工作单位有孩子是生育津贴
退款成功后运费险没有到账怎么办	退款成功后运费保险不张
办太平洋保险需要户口本吗	太平洋保险需要户口本
天猫退款一栏没体现还能退运费险了吗	没有反映出淘宝商城退款列还可以退运费保险
工伤鉴定所鉴定十级残疾保险公司怎么赔偿	工伤鉴定评估十级残疾保险公司如何弥补
城镇居民自己交的社保退休时如何计算退休金？	城市居民自己社保退休金支付时如何计算?
对方全责我的交强险保单不见了,保单号可以么	另一方完全我的保险政策,政策数量
养老保险未交满五年可以补交吗?	养老保险可以不缴纳满五年回来?
银行买泰康人寿保险（分红型）的理财产品到期怎么样分红	银行购买泰康人寿保险(分红)的金融产品如何分红
保单生效日期和起保日期的区别	政策生效日期,确认日期之间的区别
交强险赔偿范围，自己开车把护栏撞坏应该怎么办	保险赔偿范围、驱动器崩溃障碍应该如何去做
离婚财产申保费退吗	离婚财产”保费退款
缴纳一年的保险费工亡补偿金是多少	缴纳的保险费是多少一年的劳动补偿吗
强险里面到底有三者吗?	三个强有力的风险如何?
40,50自己上保险应准备什么材料	应该准备什么材料40、50在你的保险
失业后向谁要失业费？	失业后应该向谁失业费用吗?
学生交的意外伤害保险单身份号不对怎么办	学生支付意外伤害保险单身份证号码是错误的
新*农村户口可以一次性领失业金吗	*新农村户口可以一次性申请失业救济人数
护理的反本型建康险是什么意思	处理这种类型的医疗保险是什么意思
重大疾病保险到80岁如何办理返还手续	重大疾病保险的80岁高龄的如何处理手续的回报
万能险买15年好还是20年好	万能保险15年或20年好
退休后，我能领取多少社保养老金	我有多可以买社保退休后养老金吗
新农合去年没交今年是否可以交	今年新农去年没有付,如果我可以支付
一次性伤残补助申请上交后多长时间能收到补助金?	要多长时间才能一次性伤残应用程序接受资助?
交了三年零三个月失业金能拿多少钱？	移交三年三个月的失业救济金可以得到多少钱?
自己交医疗报险怎么交	自己如何交付健康风险
农保和成保有什么区别	有什么区别农业保险和维护
什么是团体保险，团体人寿保险的险种包括哪些	什么是团体保险、团体人寿保险覆盖范围包括什么
农银宝一号在犹豫期退保如何办理	农业银行宝在犹豫期前如何处理一个数字
同等责任事故车损理赔在投保公司理赔就可以吗?	平等的责任事故CheSun要求保险公司索赔了吗?
保险公司不履行代位追偿怎么办	保险公司不履行代位复苏
社会保买几年	社会保险购买几年
什么保险投保人可以随机选择缴费方式和缴费期间	什么样的保险投保人可以选择随机在方式和付款
如果退保险能损失多少、谢谢	如果退还保险能损失多少,谢谢
城镇居民交通事故十级，对方有交强险怎么赔偿？抚养费怎么计算？	城市交通事故十个步骤,彼此有保险金吗?
干满6年半大约能领多少失业金	干燥与六年半就会带来很多好处
失业金交了47个月可以领多少	可以获得失业救济金47个月多少钱
车有全险车祸造成受害人死亡的我们负主要责任保险工司怎么理赔	汽车一切险死亡车祸的受害者索赔我们主要负责保险公司
城镇居民医疗保险报销比例是多少	城镇居民医疗保险报销比例是多少
个人所得税怎么交	如何缴纳个人所得税
人身保险的受益人可以是非亲属关系的人吗	人身保险的受益人可以相关
招商信诺推出的Vip国际医疗险有哪些特点？	招商信诺Vip的国际卫生保健的特点是什么?
失业金领取	失业救济金领取
新华保险祥和万家和健康福星哪个好	新华保险和和平,健康和融合
吉利相伴a款两全保险分红型包括里面有意外险吗	吉利养老保险公司分红,包括内部有伤亡
不计免赔特约与不计免赔责任险有什么区别	没有没有危险责任的特许经营的特约避免补偿有什么区别
车子买了交强险,缴车船税时需要保险单吗?	当汽车买保险的需要,支付汽车保险政策?
国家规定现在低保家庭成员要买意外险吗?	现在国家规定低家人买保险吗?
中*平安保险里的尊越人生与尊御人生哪个好	*生活在平安保险的雕像和皇家生活的美好
天安人寿天保盈之富贵年年这个怎么买	天安生活如何购买的天保盈繁荣的一年
保险到期后可以一次取出吗	保险到期一次可以删除
个人养老保险如何转到新单位,需要什么手续	如何将新单位的个人养老保险,需要哪些手续
伤残等级评定后需要多长时间才能获得理赔	伤残等级后要多长时间才能索赔
在工行买华夏人寿财富一号两全保险c款如何退	在工商银行购买华夏生活财富养老保险c如何返回一个数字
强制险那个伤残费不满一万咋报	强制保险,ShangCanFei少于一万咋
中国人寿保险公司刚新推出的鑫如意好不好？纠结	中国人寿保险公司刚刚推出了一个新鑫运气吗?
我26岁，买平安福综合保障计划一年交多少钱	我26岁,买综合保障计划每年支付多少钱
保险合同被保险人的名字不确认怎么办	保险合同被保险人的名称不确定
新华保险吉祥如意的满期领取需要些什么	新华保险到期收到什么需要运气
如何以个人的名义缴纳养老保险可否一次性缴纳	的名义个人如何缴纳养老保险支付吗
万能险的高额件是什么意识	高意识的全民覆盖是什么
强制险有法两个公司一起上吗	强制保险补贴这两家公司在一起
车辆未年检,可以互碰自赔吗?	车辆年检,可以触摸的补偿吗?
交强险务工费能赔多少	补偿费用保险工作呢
保险公司是否有追缴保费义务	保险公司已经恢复,保险费的义务
幸福福*宝*号两全保险犹豫期内退保收多少钱	养老保险幸福f * *宝犹豫期你收费多少投降
已买商业不计免赔车险`还要自己赔钱吗	我们必须购买商业不包括特许经营车险的还花自己的钱
合众人寿是不是倒闭了	现代生活是封闭的
商品车运输途中出险了，保险公司怎么走保险流程	转口货物车或摆脱危险,保险公司如何获得保险过程
失业金领完后如无就业还可领取吗	如果没有就业失业后,金陵还可以接受
离职后一年离职合同才下来国家给事业险吗	一年之后离开只有国民离开职业风险的合同
我把别人的车撞了,第三责任险能赔偿吗	我有别人的车撞了,第三可以赔偿责任
之前辞职后社保卡丢了,一直没补,现在单位要社保卡报医疗费怎么办	辞职之前社保卡丢失,没有填写,单位应该现在社会保障卡医疗费用
农业户口可以买社保吗在平*山可以吗	农业户口可以买社保请在平*山
年总奖7500能缴纳多少个人所得税	年总奖7500多少缴纳个人所得税
没有土地住房工作非农户能享受五险_金吗	没有土地的房地产工作的农民可以享受5 _黄金的风险
我想买份保险！但不懂什么叫保险！也不知道什么是保险	我想买保险!
协议存款属于一般存款吗?是否享受保险制度	一般存款协议存款属于?
本车驾驶人的人身伤亡可否获得交强险赔偿	默认的司机的人身伤亡保险金
鞍钢退休职工想办理异地就医到什么地方办?地址在哪？	鞍山退休工人想处理这段漫长的距离到达的地方去看医生做什么?
住院医保报销完后可以改为自费报销吗	医疗保险报销后,我们可以在他自己的费用报销
人保第三者险小车第三年交多少	多么危险的第三方保险车辆在第三年的付款
汽车发动机进水为何保险公司不赔偿	汽车发动机为什么保险公司不赔偿
收到保单，但还在犹豫期怎么退保	收到的政策,但还在犹豫期如何投降
中*平安的智胜人生万能险？有什么优缺点	*和平智胜万能人寿保险?
退款成功后运费险没有到账怎么办	退款成功后运费保险不张
招商信诺少儿险产品的特色是什么？	招商信诺的特点小危险是什么产品?
买信诺重大疾病险要体检吗？	它受到一个医学信诺买重大疾病?
车辆静止发生人员伤亡三责险赔吗	汽车静态伤亡发生在三个主要的风险补偿
老人适合买什么险种	老人买什么险
买车要买商业险这个险种是起什么作用的	一辆车购买商业风险这一险种的功能是什么
招商信诺大病险保障的范围是什么？	什么是招商信诺破旧的大范围的安全?
船舶的保险是以什么样的形式存在的？？	航运保险存在的形式是怎样的? ?
社区大病统筹和人寿医疗保险有冲突吗	社区作为一个整体和大病医疗保险的生活有冲突
刚买10天的泰康人寿幸福人生b款现在急需钱退款的话要几天?	刚买了10天泰康人寿的幸福生活b是急需钱退款几天?
车被盗找回，车辆受损保险理赔吗	汽车被盗,车辆损失保险索赔
公共责任险的特点是什么	公众责任保险的特点是什么
怎么购买重大疾病保险好？	重大疾病保险是什么?
机动车撞伤人至骨折保险公司该怎么赔偿	机动车撞骨折保险公司如何补偿
中*人寿防癌疾病保险内容怎么样	*生活癌症疾病保险的内容
人身保险投保前需要体检吗	需要一个医疗保险保险前
机动车购买的交强险发生了交通事故但架驶员没有架照保险公司应赔偿吗	有一个交通事故保险机动车购买但是没有齿条传动成员根据保险公司应该赔偿
法院判决七级伤残保险公司应按法院执行吗	法院判决7残疾保险公司应当根据法院进行
中国人寿保险国寿鸿盈两全保险的适用范围时什么	中国人寿养老保险ShouHong完整的范围
给女儿买了保险能不能换别的险种阿（平安保险）	给女儿买保险可以改变其他保险(平安保险)o
保险公司赔给一个人的受伤医药费，那笔钱是从哪来的？	保险公司赔偿受伤的人的医疗费用,这笔钱从何而来?
员工200元购买意外险,手指受伤告雇主,可以把保险公司也一起当被告起诉吗?	200元购买保险,员工对雇主手指受伤,当被告可以一起起诉保险公司?
走保险公司报销身份证复印件可以用吗	去保险公司报销可以使用身份证
交通事故出了一点青伤住院几天就可以出院了,保险公司应该赔偿多少钱	交通事故是有点绿色受伤住院几天可以出院了,保险公司应该赔偿多少钱
交通事故九级伤残负主要责任保险公司交强险能赔付多少，年龄66岁	主要负责交通事故9级伤残保险的保险公司可以支付多少,享年66岁
大拇指断了半截,100元管一年的意外险承保吗	拇指坏了,100元一年伤亡保险吗?
无证驾驶交强险理赔吗？保险公司理赔后还起诉车主吗:	无证驾驶保险索赔?
交通事故我全责,对方起诉我和保险公司还有货车的挂靠公司,我要负责吗?	交通事故我单纯,另一方起诉我货运和保险公司附属公司,我负责吗?
保险公司追偿是向车主还是肇事司机？	从保险公司的所有者或复苏司机吗?
中国人寿，国寿鸿盈两全保险（分红型）怎么样啊？	中国人寿保险,养老保险ShouHong盈余(分红)?
每个保险公司交强和车船税一样吗	每一个保险公司支付和汽车一样坚强
交通事故轮胎损坏保险公司赔偿问题	交通事故轮胎受损保险问题
农村九级伤残赔偿标准我父亲.因矿采煤塌陷至伤残九级应赔多少钱	农村9类禁用我的父亲补偿标准。
向保险公司申请八级伤残以后多长时间会到账	向保险公司申请多长时间到达后改变了残疾
海运保险的保障范围有哪些?海运保险的除外责任有哪些?	海洋保险?
异地事故报保险需要当时签纸档合同么	不同的地面事故报保险需要签署文件
投保空中运输保险有什么要注意的吗?投保空中运输保险注意事项有哪些?	航空运输保险需要注意什么?
外地开先天性的白内障农村医疗保险能报销吗	农村医疗保险报销的先天性白内障可以
单方事故司机重伤抢救费强制险给报销吗	单方面的司机事故救援费用强制保险报销
电梯把人夹伤了电梯的保险公司会理赔吗	电梯的电梯的保险公司索赔
没有驾驶本开车把车碰了保险赔吗	没有JiaShiBen开你的车去碰的保费
在工地干活摔伤没有劳动合同老板给交意外险怎么索赔怎样走程予	在建筑工地工作的伤害没有劳动合同的老板如何支付保险索赔流程如何走
小孩买的意外险,在急诊用的现金没发票怎么能报销	孩子购买保险,在急诊科用现金没有发票可以报销
自己不过小心撞凹台车保险公司会赔吗买了全保	丁车自己但是要小心购买一切险保险公司会赔偿你
工商银行幸福福盈宝在犹豫期内怎样退保	工商银行幸福祝福宝在犹豫期内如何投降
儿童医疗保险怎么办理?	如何应对儿童健康保险吗?
刚买的车，强制险标志丢了，能委托补办吗？	刚买了一辆车,失去了强制保险标的,可以委托补办吗?
寿险到期返回的款还受法律保护吗	人寿保险过期退货仍受法律保护
汽车保险理赔身份证丢失了怎么办	汽车保险索赔身份证丢失
海运保险是什么?海运保险有哪几种?	海上保险是什么?
10岁和家人打架后喝农药,算自杀吗,意外险能理赔吗	经过10年的年龄和家庭斗争喝农药,自杀,伤亡索赔
太*洋保险车子没有办理机动车行驶证可以理赔吗	太*保险没有办理汽车机动车驾驶执照可以索赔
取暖器引起的火灾可以申请家财险赔付吗	加热器火灾可以申请保险索赔
老师54被车子撞死,对方付全责,应该赔偿多少钱?	老师54被车撞了,对方付全部责任,应该赔偿多少钱?
请问商业重疾保险报案需要什么程序	商业大病保险,请报告需要什么手续
第三者责任险赔偿事故己方车辆维修费吗	第三者责任保险事故赔偿他们的车辆维修
保单没收到，保险昨天已生效，在异地能退吗	保险政策收到了,昨天是有效的,在长途可以退款
机票已经退保了那退款什么时候退	票已经投降时退还回来
购买商业保险用的是身份证复印件及户口本合法吗	买商业保险与身份证和户口本的法律
满期保险金是指返还之前交的保险费吗	保险是指返回期满前支付的保险费
到报废年限的机动车能交强险吗	能丢弃的机动车保险吗
人寿重大疾病保险投保人和被保险人不是同一个人可以吗	人生的重大疾病保险投保人与被保险人不是同一人
撞死人保险公司赔,个人还要赔吗	事故保险公司赔偿,个人需要补偿
意外险的死亡与残废赔偿有区别吗	有什么区别死亡和残疾的伤亡补偿
如果缴纳途中失业了呢？	如果你支付的工作吗?
凭什么证件办理异地医疗保险转移	处理移动远程医疗保险与文档
查间自己的保单。	检查他们的政策。
个人养老保险要怎么交，每月该交多少	个人养老保险待遇如何,工资一个月多少钱
交五险一金，可以领独生子女的补贴款吗？	五种社会保险和住房公积金,可以把独生子女奖励?
襄*失业金没有到账怎么办?	协助*失业救济金不张?
2016年一月份失业金发放了吗	2016年1月,失业支付
社保转交农保还能再交社保吗	农业保险社会保障转移支付社会安全吗
自己包活干自己受伤属意外伤害吗，医保能报吗	包工作自己受伤属于意外伤害、医疗保险能报
续交强险没有身份证复印件怎么办	继续支付保险没有身份证副本
办理失业金领取需要居委会出具什么文件	失业救济金的居委会出具任何文件
个人交养老保险到65岁死亡还能领到其余的吗?	个人缴纳养老保险的65岁高龄的死亡也可以休息?
四十五岁交社保还会交生育险吗	45岁支付社会保障将出生的危险
从没交费的养老保险可以申请注销吗	从来没有缴纳养老保险可以申请取消
社保隔了两年开始交什么时间激活	两年后社保/激活什么时间的开始
在单位断断续续上班几十年单位是不是必须交保俭	在单位,工作几十年必须保释浪费
换号退保要变更需要什么手续	改变他们的投降的过程改变
保险公司已定损但未赔付算不算出险	保险公司费用,但没有支付是不会或摆脱危险
车险快到期,先续保再维修划痕还是先修再续保哪种比较合	汽车保险即将到期,首先同意修复划痕或修复的更新了
没有拿到保单,办退保没有签退保申请能给退吗	没有购买保险的政策,做投降不能签署贷款申请退款
我调新单位档案没动能上养老保险吗	我调整了新单位养老保险文件没有动能
机场买的平安综合意外险保航班失事吗	机场买的平安综合灾害保险
合同到期辞职公司交的部份五险一金是否扣除	合同辞职公司支付五项社会保险和住房公积金部分扣除
女性满45岁可以办退休职工保险吗缴费15年了	45岁的女性做一个退休工人保险支付15年
单位买了重大疾病保险退休后能享受吗	单位购买重大疾病保险退休后可以享受
商业养老保险子女能继承吗怎么计算	商业养老保险的孩子可以继承如何计算
户口本上有几人就要交城镇医保吗	由于在城市户口本上几个人的医疗保健
人民币贬值对保险公司可有影响？	折旧影响的保险公司可以吗?
为什么强制保险交那么多钱才给保2000啊	为什么强制保险支付这么多钱来保护2000
在不同地方交失业保险领取失业金怎么领	在不同的地方缴纳失业保险领取失业福利
人寿*康*个人护理保险(万能型A款)什么意思？	生命* *个人护理保险(万能型)你什么意思?
医保才办不道一月意外受伤可以报吗	卫生保健不仅在一月份,伤害可以引用
开车碰到行人，致人受伤了，下一年保费有打析吗	开车遇到行人,受伤,明年溢价已经演奏分析
生存金领取与保单有什么影响	有什么影响的生存金和保险政策
意外保险报销药费吗？	意外保险报销吗?
生育保险补缴过后还能享受生育报销吗	生育保险支付后还可以享受生育报销
中*财产保险车辆强险理赔包括哪些	*含有强烈的财产保险汽车保险索赔
建筑企业的意外保险包括施工现场外的地方吗	构建企业意外保险包括建筑工地以外的地方
平安智胜人生终身寿险和农保冲突吗	智胜人生生活和农业维护和平的冲突
退休时单位没按特工种加工龄怎么办	当我退休的单位没有按代理和工龄
从异地转养老保价到本地接着买可以吗，需要那些手续？	从长途可以买养老保险到本地,需要的手续吗?
平安划痕险有不计免赔吗	和平没有特许经营风险
鸿运安行保险怎么样	鸿运做保险
刚买的保险保单需要跟踪吗？	刚买的保险政策需要跟踪?
到底有哪些常见的情况是车险不保的？	到底有哪些常见的情况是在汽车保险吗?
请律师与保险公司协调多久才能拿到钱	律师,请配合保险公司需要多长时间得到钱
单位交金社保卡资金什么时候到账	单位/社保金卡当基金账户
什么样的伤残可以起动交强险中的十一万	什么样的残疾可以开始保险在一百一十
固定合同到期公司不给续签有补偿金吗	固定合同公司没有更新他们的补偿
农村养老保险帐户钱存多了能退回吗	更多的钱可以返回农村养老保险帐户
鑫盛保险可以拿回本金吗	鑫盛主要保险可以收回
车险停交两年还能交上吗吗年审有影响吗	汽车保险在两年内你也可以让它仔细的影响力
团体人身意外伤害保险必须是员工吗?	团体人身意外保险必须是员工吗?
单位没交社保，自己交的，怎么办	单位没有缴纳社保,工资如何
工作满10年，公司不续约，赔偿？还是补偿？	工作满10年,该公司不续约,补偿?
意外受伤新农合和保险公司可以都报销吗?	新农民和意外伤害保险公司能报销吗?
不是保险公司的人买卖保险,也没有保险单,能买吗	没有人购买和出售保险,没有保险,你可以购买
非农产业户34岁可以交社保吗?如何交	非农产业,34岁的家庭可以提供社保吗?
只交五险老了可以领多少钱	只有五个保险旧可以得到很多钱
月尾能否办理失业保险	是否每个月处理失业保险
车辆不年检不买保险可以上高速吗	不能在车辆年检不买保险吗
37的女人,买保险,疾病养老的，什么险种适合我	37岁女性,购买保险,养老,对我什么风险
强保跟全保必须的一个人的身份证吗	覆盖所有风险都必须是一个强有力的人的身份证
关于新车的保险在网上买还是在保险业务员或是公司柜台买	新汽车保险在线或在柜台或公司购买保险推销员
太*人*少*守护一生保险怎么样	太* * *少保护人寿保险
中国平安保险的金裕人生可以报销住院费吗?	中国平安保险(ping an insurance)金余生活住院可以报销吗?
百年人人寿保险犹豫期是多长时间	一百人人寿保险犹豫期长
国寿鸿盈两全保险分红型是一款怎样的险种	ShouHong养老保险的分红是一个什么样的风险
招商信诺重疾险包括哪些重大疾病？	什么是招商信诺的重大疾病的风险严重的疾病吗?
想给孩子入保险哪个公司险种比较好	哪个公司想给他们的孩子到保险比较好
买得人寿的学平险被狗咬了可以报多少?	平的生活购买风险被狗咬伤,可以报价吗?
请问一下，我买的是泰康人寿幸福人生A款终身年金保险（分红型），这个有没有什么风险？？？？	对不起,我买的是泰康人寿幸福生活——一个终身年金保险(分红),有什么风险呢? ? ? ? ? ? ? ? ? ? ? ?
女三十岁，平安的鑫祥和智胜人生万能险哪个适合我?	女性30年,鑫的和平与和平智胜万能险适合我吗?
合作医疗保险转市报销需要什么手续	合作医疗保险报销,需要什么手续
汽车强保死亡赔十万如果受伤住院赔多少	强大的汽车保险死亡补偿补偿多少数千如果受伤住院
中国人寿的瑞鑫保险适合1岁以内的孩子吗	瑞鑫中国人寿保险适用于1岁内的孩子
我的工伤发票掉了，能够补回来吗？	我把发票的工伤,可以修复吗?
低保人群的意外伤害保险卡丢了可以补吗	低收入人群可以填补意外伤害保险卡丢失
20岁以上的人无身份证只用户口本办保险能成保吗?	20岁以上的男性和女性,没有身份证。
医疗保险中断了咋办啊没法补	医疗保险中断,无法修复
中邮人寿保险公司的中邮富富余1号两全保险，有人买过吗？咋样？	在人寿保险公司寄邮件丰富养老保险没有。
商业车险如何计算	商业汽车保险如何计算
汽车只交了强制险撞到人在医院花了五千能报吗?	汽车强制保险只打人在医院花了五千能报吗?
六十五岁以前可以补交养老保险吗?	六十五岁可以支付养老保险吗?
平安大病保险所保大病有哪些	和平的大病保险确认什么是一个严重的疾病
私家车托运保险必须上吗？	私家车在保险必须检查吗?
每年要到什么时候才可以申请大病保险	每一年,直到什么时候可以申请大病保险
保单签过了，钱还没扣走可以退保吗？	保单签署,钱没有可以删除扣吗?
领取工伤保险金需要什么手续	工伤保险需要什么手续
五十岁养老险怎么买	五十岁如何购买养老保险
有社保报销了,那人身意外险也能否报销	有一个社会保障费用,人身保险能报销吗
买保险才两年五十岁能退休吗	买保险只两年50岁就可以退休
有没有专门保交通意外的保险？	你有什么特别的保护交通事故保险吗?
我上班2个月辞职公司不给我保险金怎么办	我工作2个月退出该公司没有给我保险
31号辞职次月保险公司该缴纳吗	31日辞职后,保险公司应支付
以前交过保险也有卡转保险需要带身份证吗	支付保险之前也有保险需要带身份证
农行养老保险两年到期后能否取钱	养老保险将农业银行取钱后由于两年了
新车出险一次第二年会有影响吗	新的薪酬第二年会有影响力
购买汽车保险应该遵循哪些原则	买汽车保险应遵循的原则
建筑公司退场,工伤保险可以退吗	建筑公司退出,工伤保险退还
领取死亡赔偿金在哪领	在哪里可以接收死亡补偿选择
银行保人有效期是多久	申请人银行的有效期多长时间
距退休一年半时间能否停交五险	从退休一年半时间可以停止五险
买少儿大病险一定要加分红险吗？	买孩子的大渗流路径必须增加分红保险?
驾驶证在有限期内可是没有年审保险公司给理赔吗	驾照在有限的时间内,但不小心要求保险公司
中国太平人寿保险教育险买了可以退吗	中国太平洋人寿保险教育风险可以买回来
企业缴纳失业金需要先办理失业证吗	公司支付失业救济需要办理失业证
什么是人身意外保险，人身意外保险理赔的流程是什么	人身意外保险,人身意外保险索赔过程是什么
中*平*保*重大疾病投保多久住院能报	* * *宝萍是重大疾病保险将报价多久去医院
重大疾病保险怎么买？	重大疾病保险如何买房?
平安保险万能险主要适合什么样的人群投保	平安保险(Ping an insurance)普遍主要适用于什么样的风险
人身意外保险可以保障猝死吗？	人身意外保险可以猝死?
重疾险有多少种疾病	大病保险有多少种类的疾病
车购税为什么会有滞纳金？	为什么会有滞纳金车辆购置税吗?
营业性车辆与非营业性车辆保险费率是否相同	商用车辆和商业汽车保险费率是一样的
买平安福保险有没有犹豫期	买保险你有任何犹豫
交强险别人把我撞了有赔偿吗	有补偿保险有人撞到我吗
哪些原因造成保险车辆损失，保险人不负责赔偿	保险车辆造成的损失,保险人不负责赔偿
车出车祸交强险与商业险不是一家怎么理陪	什么车祸保险和商业保险不是理由陪
倒车撞墙了买了全保保险陪多少	背靠墙都伴随风险保险
祥和万家是什么保险	和平,是什么保险
信诺重疾险报销需要提供哪些资料	信诺重疾病风险需要提供什么数据
98年辞职的职工怎么办理社保和医保	98年,辞职员工如何应对社会保障和医疗保险
自动挡改手动挡影响保险理赔吗	自动改变手动影响保险索赔
42周岁的女士在单位可以交五险一金吗	42岁以下的女性在单位支付五种社会保险和住房公积金
买车人不转强制保险对卖车的有害吗?	买主不有害强制保险卖车?
没提供单位社保编号可报销生育费吗	没有提供社会安全号码可以报销的方向
如果医保有两年未交现要迁到外地要不要补交	如果卫生保健有两年没有支付现在搬到其他地方你想填满
我个人同时保多种意外伤害险,发生意外伤害时享受几份赔偿	我个人支付各种意外伤害风险同时,意外伤害发生时享受一些补偿
工厂倒闭三险一金怎么赔偿?	工厂关闭三个保险如何补偿?
基本保险金额是什么	基本保险金额是多少
防癌险赔付方式?怎么缴费怎么赔付	癌症风险补偿?
我每月失业金755能办低保吗	我每月的失业救济金755可以申请低
万能寿险具体有什么保障	普遍生活具体有什么保证
七级工伤主动辞职能办理失业险吗？	七个工伤可以辞职处理失业保险?
买车的时候第一年买的是全险，第二年用不用买全险了？	买汽车时第一年购买一切险,用在第二年购买一切险吗?
保防癌险和疾病险假如我到死都没有生这病最后能拿回本金吗？	预防癌症风险和疾病风险如果我死亡的疾病最终回到生活吗?
在职员工申请退保如何办理	员工申请前如何处理
保险到底是什么？	什么是保险?
买了大病险,在180天内中风了,保险还有用吗?会不会失效了	买了一个大渗流路径,中风的180天,保险和使用?
包工头可以买到顾主责任险吗	承包商可以购买雇主责任保险
自己上保险能吃就失业险吗	他的保险失业保险可以吃
生育保险孩子三岁了男方可以报销吗	生育保险的孩子3岁男人可以报销
出了工伤没交社保没签合同怎么办	工伤未支付社会保障没有签合同
非本地户口下岗了保险交了有十几年了,可以自己交吗	非本地户口的下岗保险支付12年,你可以做你自己
车险可以团购吗？	汽车保险可以团购吗?
中*人寿福寿年年有哪些保障	*每年生活居住安全
人寿保险退订手续费要多少	退订人寿保险费用多少
泰康人寿分红型保险怎么样	泰康人寿保险的分红保险
入保险的好处入保险有什么好处	有什么优点保险金的保险吗
企业一年多没给员工交五险，员工该怎样维权？	企业一年多没有给员工支付五个保险,员工权利如何?
43岁女性购买哪种重大疾病险比较好？	43个女性购买什么样的重大疾病保险比较好?
到退休年龄了又多交几个月社保咋办	退休年龄和支付几个月的社保
天安人寿富贵年年年金保险（分红型），有什么风险吗？	天安人寿繁荣年年金保险(分红),风险是什么?
车辆发生伤人事故,明年保费上浮多少	多少车辆伤害事故,保费增长明年
万能险的本质是什么？	全民医保的本质是什么?
国家厂职工在没退休时去世后,以前所交养老金能退还吗?	国家不是退休工人死后,支付养老金返回吗?
4S店上的车险和保险公司上的车险一样吗？	4 s店汽车保险和保险公司汽车保险吗?
公司给我上的三险可是我自己查没有养老我可以告他吗	公司给我三个风险但我检查没有养老金,我可以告诉他
买新华人寿保险公司的红双喜分红险安全吗?	购买新的中国人寿保险公司的安全双喜红利政策?
公交车的车险为什么一年比一年交的钱多	为什么巴士汽车保险每年有更多的钱吗
女性买重疾保险必须覆盖的重疾有哪些？	女性购买重疾病保险必须涵盖疾病?
人寿保险犹豫期从哪一天算起？	人寿保险犹豫期从哪天?
外地户口迁到本地交职工养老保险有区别	外地户口迁往当地职工养老保险有区别
两车相撞我是次要责任,赔偿金额1000元,那下一年的保费提高多少	两辆车相撞我是次要责任,赔偿1000元,明年多少保费增加
如果犹豫期是十天我在最后两天退保又刚好是星期天那应该怎么办	如果十天犹豫期在过去两天,我周日投降,到底是应该做什么
新车刚买3个月被撞对方负全责用法律起诉能得到什么赔偿?	新车刚买3个月被击中对方承担全部责任的法律起诉可以得到补偿?
单位没给我买失业保险，我个人能在社会上买吗	单位没有给我购买失业保险,就我个人而言,我可以买到社会中
车险中的商业险和交强险英文缩写是什么	什么是汽车保险的商业保险和保险缩写吗
领着失业金还可以交失业险吗	领失业救济金也可以缴纳失业保险
买车第二年需要去车管所办手续吗?	第二年买车需要去车管所手续吗?
企业交养老保险可以返到个人账户吗	企业支付养老保险个人账户可以返回
非工作日，在出租房宿舍做公司的事。意外猝死，能否算工伤？	一天,租赁公司宿舍。
刚考驾照不久开车没强险可以不罚款吗?	只是驾驶考试很快强劲无保险不能驾驶好吗?
退款成功后卖家关闭了交易运费险会什么时候到账	退款成功后卖家关闭交易货物的风险何时到来
学前班小孩星期六在家弄断了手,保险公司有赔偿吗	学龄前儿童在家里周六打破了他的手,保险公司赔偿
车险费率市场化有没有实施	汽车保险费率市场化实现
我的车撞了之后没报警修好后派出所需要出什么证明保险公司才能报消	我被车撞了后没有报告警察局修复后需要什么能证明保险公司消失
怎样知道车险理赔的详情	如何知道汽车保险索赔的细节吗
有了大病了,还能交居民医保吗?	有严重的疾病,但也使居民报道吗?
职工医保和农保的区别-百度	工人健康和农业保险的区别——百度
新买的车刚交了一年的强制险可以改名吗	买了一辆新车就交了一年的强制保险可以改变名字
刑满释放人员可以买商业保险吗	一个人在服刑完毕后发布可以买商业保险
请问，交通事故受伤者要求赔偿精神损失费，保险公司可能赔吗？	交通事故受害者,请要求损失赔偿,保险公司可以赔偿吗?
车险抵押是什么意思	抵押贷款的汽车保险的意义是什么
酒驾执照调消后开车出事故后,保险还可以报吗?	醉酒驾驶执照驾驶事故消除后,也可以报保险?
六十九的人去打工受伤后能要求老板付误工费吗	六十九人上班在受伤后问老板支付的钱
车辆损失险的赔偿限额是逐年递减的吗?	汽车损失的赔偿限额逐年减少危险?
人寿保险合一同还没下来可以退款吗	人寿保险同一性和没有你能退款
一个人可以买几份寿险人身险？	一个人可以买一些人寿保险人寿保险吗?
办社保两年了都没有交钱,可以退保吗	社会保障办公室两年不赚钱,你能投降
国寿福禄鑫尊两全保险分红型每年领多少	ShouFuLu鑫尊养老保险的分红每年将多
养老保险可不可以从高档次转换低档次?	养老保险可以转移从高档低品位?
国寿瑞鑫两全保险与国寿千禧理财两全保险那种比较好?	国家养老保险ShouRuiXin和生活的年养老保险融资更好?
小学生在课堂上不小心致他人受伤保险公司有赔付吗	小学生在课堂上不小心造成伤害保险公司支付
我主责对方次责,对方摩托车无保险怎么赔付？	我主要负责其他时间,如何补偿对方摩托车没有保险吗?
交通法规小轿车正常行驶,大货车撞了小车,导致小车报废,四人死亡,怎么理赔	交通规则的汽车移动,大卡车撞到一辆汽车,导致废车,四人死亡,如何索赔
国寿瑞鑫两全保险分红型适合哪类人投保	的养老保险ShouRuiXin分红保险适合什么样的人
2015年7月1号在网上可以购买车险吗	2015年7月1日可以在网上购买汽车保险
社保卡没在身边怎么办，看病需要社保卡工厂才能报销，怎么办?	社会保障卡在背后,看医生需要一个社会保障卡工厂报销,怎么办?
合同到期自己不续签失业金能领吗	合同不延长失业救济金将自己
交养老保险，中间人没了，保险是全部退款吗	缴纳养老保险、代理,保险是一个全额退款
关于国寿安享一生两全保险(分红型)领取方式需要哪些手续	关于养老保险享受生活的生活(股息)接收需要什么手续的方式
去外地报销生育金,失业证明哪里盖章	金报销,失业率证书盖章
被公司辞退后最长多少日主张领一取失业金	多少被解雇后最长的一天带来了失业救济金吗
个人办理暂停社保到哪个部门拿什么东西	人办理暂停社保部门需要什么东西
买车第三者保险是否包括事故施救费	是否买一辆车的第三方保险,包括事故救援
商业车险第三责任险有代位求偿权吗?	商业汽车保险的危险责任的第三代位权吗?
工伤事故后可以向公司追偿如职时未买的五险吗?	工伤事故发生后,可以恢复从公司不像买了五个保险?
车辆保险全责方拒绝在理赔单上签字怎么办？	车辆保险责任政党拒绝签署索赔单吗?
平安的鑫祥两全和人寿的鸿*两全哪个好?各自的优点和缺点是什么?	鑫的平安和吉祥是满意的生活亲爱的*满意的哪个好?
农商险和工商险有什么区别	农业和商业风险的区别是什么
私家车购买了司乘险，发生车祸自己负全责，司乘险赔不赔住院治疗费用？	采购部冒险,私家车在一次车祸中他的全部责任,公司承担风险不补偿补偿住院费用?
现在农村户口可以买城镇职工养老保险吗	现在农村户口可以买城镇职工养老保险
农村医保可不可以用来打小孩呢?	农村卫生保健并不是可以用来打孩子吗?
十七岁的男孩打架没构成轻伤怎样理赔	17岁的男孩打架不构成一个小的调整
交强险怎么理赔	保险索赔如何
车险在什么情况视频定损	汽车保险在视频费用
公众责任保险与第三者责任保险有何异同	有什么异同公众责任保险和第三者责任保险
意外险买个几份可以同时理赔吗	伤亡买几可以声称在同一时间
国寿福满一生和福禄满堂哪个更合适?	国家ShouFu充满活力和繁荣的祝福哪个更合适?
多大适合买养老保险或者社保	购买养老保险和社会保障多少
企业职工养老保险能二次申请吗?	企业员工养老保险辅助应用程序?
个人购买的生育险是否有产假待遇?	个人购买生育险产假吗?
企业是否可以与员工商量要社保	企业能否咨询员工社会保障
对方车保险理赔以后意外医疗保险怎么赔	另一辆车事故和医疗保险保险索赔后如何补偿
外地户口买的到互助金不?	外地户口买相互黄金吗?
新车刚刚交了一年的强制险可以改名吗	新车刚交了一年的强制保险可以改变名字
腿撞折了起诉后多长时间能得到理赔	腿打折起诉后多久可以得到索赔
在外地报车险怎么还得回本地开申请呀	外的汽车保险怎么也回到本地打开应用程序
办失业保险单位少写了工作年限怎么办	写更少的失业保险单位的工作生活吗
强制车险到期转全保需要些什么流程?	强制保险一切险由于将需要处理什么?
五险一金办理个人需要提供什么证件	五种社会保险和住房公积金个人需要提供什么证书
车子在外地出事故了对方全责他要把理赔资料给他再给我打款可以吗?	车祸在彼此全部责任他要给他初请失业金数据可以给我钱吗?
叫了个没有妻儿的亲戚干活发生意外死亡如何理赔	调用一个没有妻子和孩子的亲属如何索赔工作事故死亡
车辆保险期内有过保险赔付的可以退保吗	车辆保险期间保险费投降
一小时航班需要买意外险吗？	一个小时飞行需要买保险吗?
外省保险公司赔偿金具体赔偿时间多长	多久省级保险公司具体的赔偿
养老保险交的早有好处吗	养老保险待遇很好
医疗几次可以一次性报新农合保险吗?	可以一次性卫生几次新农业和保险吗?
被人砍伤有意外险,保险公司理赔吗?晚上被害人毫无防备被行凶者砍伤至肌腱断裂。	减少伤害事故,保险公司索赔?
一次性交养老保险要多少钱	一次性缴纳养老保险要多少钱
请问养老保险超过50岁就停买了吗？买了12年	养老保险超过50岁,请停止购买?
新农合的无卡证明怎么办理流程	新农业或没有卡显示如何处理过程
普通意外险的保障范围都有哪些？	常见的伤亡保险都有吗?
意外险生效日期	伤亡生效日期
没有农合本能报销生育险吗	没有农民和生育风险的本能
农民买养老保险怎么买	农民养老保险怎么买
我得养老保险合同丢了，怎么办？	我失去了我的养老保险合同,怎么办?
哪种分红保险好	什么样的保险分红
新车新手如何买车险	新车新手如何汽车保险
什么是保险期间和保险期限	保险期间和保险期限
不是本人可以补办保单吗	不是我可以补办保险政策
怎么补买魅族手机意外险？	如何填补购买魅族手机保险?
我是农村户口在城里能交养老统筹吗	我是农村户口在城市支付养老金计划作为一个整体
以前办理过养老金，在交要身份证吗	养老金,之前交身份证
幼儿意外险和居民医疗保险能重复报销吗	孩子们的伤亡和居民医疗保险可以重复报销
人被车辆撞死,对方赔偿后,自己保的意外险种有赔偿吗	人被车撞了,对方赔偿后,自己有补偿保险事故风险
只交了四年养老保险，就辞职了，怎么办？	只交了四年的养老保险,退出,我能做什么?
47岁男有事业单位社保医保再想买商业意外保险那个好	47岁男性和机构的社保医疗保健和想买好的商业意外保险
养老保险档案丢失怎么办?能补吗?	养老保险文件丢失怎么办?
签订养老保险合同时身份证号尾数是字母怎么办	养老保险合同时身份证号码尾数是信
今年网购高铁票加收20元的意外险，可以不要吗？	今年在线高铁票收取20元伤亡,可以不?
犹豫期内办理退保要索取什么凭证	犹豫期退保处理要求的证明
车险一年大概得花多少钱？	汽车保险一年要花多少钱呢?
从单位离职后,自己交养老保险是不是退休后没有工龄工资	从单位离职后,缴纳养老保险退休后没有工龄工资
医保卡报销是每年都交医保还是有卡就行	医疗报销是每年支付健康保险或一张卡片
买了意外伤害保险在家突然死亡能否理赔	买了意外伤害保险可以声称猝死在家里
怎么办理保单	如何应对的政策
办理劳动保险时,失业保险必须办理吗	办理劳动保险、失业保险必须处理
临时工上三险有医保卡吗	临时工在三个风险健康保险卡
车子暂时过不了户保险到期了怎么办	车暂时不家庭保险过期了
退保在有效期退与无效期有区别吗	投降的有效和无效期有区别
养老保险我交了四年了失业证怎么办呀	养老保险我做了四年失业卡如何啊
被人袭击可以报吗中*人寿意外险吗	被攻击可以引用它*人寿保险
买意外险在工地出事故,保险和起诉能同时报吗	买伤亡在建筑工地事故,保险和起诉可以报价在同一时间
退保险要合同一起退吗	投降了合同
车险必买哪几项	这几个汽车保险会买吗
人身意外险办理理赔需要哪些证件	个人保险索赔需要什么证件
失业时间是8月为什么10月才能领失业金	时间是8月失业率在10月份初请失业金人数的原因
车险报价有高有低，是什么依据呢？	汽车保险报价低,高的基础是什么?
工地上手受伤了老板该拿误工费吗	网站以适应受伤的老板拿钱
在我国汽车保险风险主要有几种?分别是	我国汽车保险的风险主要有几个?
我在工作中受伤,单位有意外险,理赔是单位办的,我不知是那个保险公司,怎么办?	我是在工作中受伤,单位有伤亡,理赔是单位,我不知道是保险公司,怎么办?
强制保险出险时需要提供什么？	强制保险时需要提供或者摆脱危险吗?
不慎被电锯锯伤100的意外险赔吗	他锯锯伤伤亡赔偿100
年审强制保险单收掉了,出事保险公司给赔吗	年审关闭强制性政策,意外保险公司赔偿
分期乐买的锤子手机怎么买意外险	快乐买锤子手机如何分期牺牲品
单位买了保险,受伤单位垫付了医药费,我想知道报销赔偿归谁	单位买保险,支付医疗损伤单元,我想知道谁的费用补偿
有什么好点的分红保险，中老年人，最好是中*人寿的？	什么好点的分红保险,老人,*生活是最好的?
养老保险单位承担缴纳部分显示1什么意思？	养老保险单位缴纳的一部分显示1你是什么意思?
因追逐而发生交通事故保险公司该负责赔偿吗	由于追求交通事故保险公司负责赔偿
因公司搬迁离职，这样可不可以领失业金？	因为公司搬家离开了,它可以领取失业吗?
事故处理后一定要到保险公司指定的定损点吗	事故处理后,必须向保险公司指定的点
个人意外险哪家比较好	人身意外保险哪个更好
公司没给员工买工伤保险，发生工伤意外该怎么赔付？	公司没有买员工工伤保险,工伤事故应如何?
请问购买车险是按车型买还是按购车发票金额买？	买汽车保险,请根据模型购买或购买的购买发票吗?
一个五十二岁的中年人在工厂上班左手伤残了应该怎么赔付	52岁的中年人在工厂工作的左手残疾应该如何支付
轿车商业险一年获两年不出险，打折吗	汽车业务风险一年两年不或摆脱危险,给我一个折扣
70岁以上老人骑机动力被机动力撞伤如何理赔	超过70岁的骑移动的移动如何索赔
改型车能投保吗	修改可以汽车保险
买养老保险划算吗？	买养老保险交易吗?
自己不小心把车刮了,保险流程怎么办	不小心划伤你的车,保险过程
汽车维修单据没给我只给发票能报保险吗	汽车维护文档没有给我只能给发票提交给保险
车被撞了,报警了,现在没空修,过2个月回去修还是一样理赔吗	汽车被撞,叫警察,现在没空,2个月回来和修复同样的说法
32岁因下班骑车不慎摔伤公司之前为我们购买了团体意外险请问我这种情况是否可以得到赔付。	32为骑自行车不小心公司工作之前我们买一组伤亡对不起如果我可以支付这种情况。
车子已经走过两次险了在次发生损伤是自己维修还是走保险	车已经过去两个风险发生在次伤害是他们修复或保险
对方全责只有交强险陪不起钱我可以用自己的保险公司赔吗自己全保包括不计免赔	彼此仅仅只有保险钱我可以用自己的保险公司赔偿你一切险包括任何特权
买社保要怎样程序？	如何购买社会保障计划?
孩子意外受伤如何理赔	儿童意外伤害索赔多少
修车把胳膊擦伤,保险公司回赔偿吗?	修复生的手臂,保险公司赔偿吗?
哪家银行可以购买商业养老保险	哪个银行可以购买商业养老保险
我已嫁出社保卡卡费怎么交	我要嫁给社保费用如何支付
车价13##00车损险加不计免赔是多少钱	车13 # # 00覆盖率和无论多少是特许经营
交强险当天出事故怎么理赔	如何索赔保险在事故发生的那一天吗
车险发生后，定损了责任方不陪怎么办	汽车保险,费用责任不陪
交强险在确认赔付金额后,必须在多少日内进行赔付	保险赔偿金额确认后,必须在多少天内赔偿
车险如何计算	如何计算汽车保险吗
我被汽车撞了,不够伤残.我想做伤残鉴定.保险公司能给赔吗?	我被车撞了,不够的残疾。
出院后伤者有伤情鉴定证明需护理保险公司该赔付吗	出院后受伤的技术鉴定损伤护理保险公司应支付
生育保险有商业类型的吗	生育保险有一个类型的业务
老人在家买了社保,还没拿退休工资,可以退款吗	家里老人买了社保,没有退休金,我可以退款
辞职后五险一金可以申请贷款吗	辞职后五种社会保险和住房公积金可以申请贷款
车险刚上不到一个月我要换车怎么办	汽车保险只是不到一个月我想改变
养老保险怎么买最好？	如何购买养老保险是最好的?
投资商业养老保险应注意的哪些关键词	什么关键词投资商业养老保险应注意
关于误工费的赔偿	关于工资损失的补偿
犹豫期内退保一定要去原来办理的地点吗?	犹豫期投降处理原始位置吗?
领取失业金要户口本复印件吗	接收失业救济金户口本复印件
保险公司法定代表人指的是什么	保险公司的法定代表人是什么
我的车子和别人擦了一下，有报警备案。车险的赔偿要办哪些手续和证明？	擦我的车和其他人,有报警备案。
浅谈现代车险理赔的发展趋势	介绍了现代汽车保险索赔的发展趋势
生育保险是怎么报销的	生育保险是如何报销
我想了解人寿养老保险有几种	我想了解生活,有几种养老保险
保险的基本保额和缴纳的数额不一样吗	基本保险和支付的数量不同
三十岁女人买哪种养老保险好如果每年1万元什么保险好	三十岁女性购买养老保险有什么好处,如果每年10000元保险
想给母亲买份商业养老保险母亲50多岁了无工作	想买她的母亲一个商业养老保险没有工作的母亲超过50岁
中*的重疾险理赔存在哪些问题?	*重病保险索赔的问题是什么?
现在新规定车辆保险一年当中报第二次增幅多少	现在新规定报告车辆保险一年当第二个增长
工人在下班途中发生交通事故导致死亡，肇事车辆有保险并已赔付；用人单位还能赔吗？怎么赔款？	工人下班的路上交通事故导致死亡,汽车保险和支付;
误工费怎么算	失去的工资是多少
被人砍伤有意外险,保险公司理赔吗?	减少伤害事故,保险公司索赔?
个人社保能在异地停保吗?	个人社会保障可以停止保护在其他城市?
我想买养老保险，请问社保和养老保险一样吗，也不知买哪种好	我想买养老保险,社会保险和养老保险,请也不知道买什么样的好
事故追尾上法院以保险公司定损定还是司法拆解定	碰撞事故保险公司在法院或司法解决
国寿福禄满堂养老保险（分红型）领取费用怎么算	ShouFuLu和养老保险(分红)收取费用如何计算
互碰自赔是用商业险赔偿，还是交强险赔偿	感动的补偿是利用商业保险赔偿,或保险赔偿
自己买养老保险怎么样合算？	自己买买养老保险吗?
安邦车险理赔查询流程是怎么样的？	商业汽车保险理赔查询流程是什么?
为什么缴纳医保后看病不能报销	为什么支付医疗保险后,医生不能报销
退休年龄到了不补养老保险之后就不给办了吗	退休年龄后补充养老保险是不做的
我把工伤资料交到社保局多久才能给我答复	我是向社会保障局工伤数据时间给我回复
单方交通事故,商业三责险是否赔偿	交通事故单方面,三个主要业务是否保险金
刚买新车什么都不知道，买车险哪些资料?怎么办呢？	只是买一辆新车,什么都不知道,什么数据买汽车保险吗?
坠崖找不到尸体保险公司赔偿吗	悬崖找不到保险公司赔偿
员工在下班途中出车祸责任是车主工伤怎样理赔	员工在下班的路上车祸责任是工伤索赔的所有者
新农合异地报销的费用清单是什么	新的农业和长途偿还是列表
商业补充医疗保险属于理赔范围吗	补充医疗保险业务属于索赔的范围
个人交的城填养老保险怎么退？要单位开退保证明，没有单位怎么办？	人们在城市养老保险如何退款?
正常退休和按政策性提前退休有什么区别	有什么区别正常退休,根据政策提前退休
房子没买保险失火了能赔偿吗	房子没有买保险火灾可以支付
电梯安装期间出现事故谁负责任,怎么理赔	电梯在安装期间负责事故,如何索赔
办理失业补助马上停保可以吗	应对失业救济金可以立即停止保护
新车3天内未买手续上路是否违反交通管理法	新车是不买手续3天内的道路上是违反交通规则
如果办理了失业金还能劳动仲裁吗	如果我能处理失业救济金劳动仲裁
如何办理异地就医报销	如何处理不同的医疗报销吗
农村合作医疗交了还能办社区医疗保险吗	农村合作医疗制度也可以申请社区健康保险
企业单位社保中的所属期可以改吗	你能改变企业单位属于社会保障阶段
我在4s店门口试驾车撞上,商品车未上牌了,我该怎么办要不要赔?	我打,4 s店试驾的车没有注册,我想弥补什么?
交通事故责任书多久出来协商完私下处理的是不是直接就可以下责任书了	交通事故责任的悠长私下协商处理是否可以在直接的责任
小车被大货车刮蹭小车保险到期没来及买对方保险公司给予赔偿吗	车是大卡车划痕汽车保险到期没来买保险公司赔偿
从以前公司不干了公司不给挪保险怎么办	从以前的公司退出该公司没有放弃保险
江淮车撞上限高栏杆保险公司拒赔怎么办	江淮帽高铁路汽车保险公司拒赔
车辆事故伤者不提供身份证能理赔吗	车辆伤害不提供身份证可以声称
工地误工费赔偿是什么标准	网站工作的补偿标准是什么
|外地员工买社保后在老家可以报销吗	|外地员工购买社保可以报销后在家乡
社保转保下午可以办理吗	可以把社保保险在下午处理吗
从事业单位辞职后原来的医疗保险金是不是会被冻结	从单位辞职后原来的医疗保险将被冻结
省医保意外保险报销多长时间能报销	要多长时间才能省医疗保险事故保险报销报销吗
在公司交了不满一年的生育险公司能辞退我吗	在公司做了不到一年的生育保险公司可以摆脱我了
现在新规定车辆保险一年当中报第二次增幅多少	现在新规定报告车辆保险一年当第二个增长
意外险保障项目有哪些？	伤亡安全项目是什么?
拿到劳动局的工伤认定后，怎样去理赔	劳动局的工伤后,如何索赔
车辆擦挂可以报划痕险吗	车辆划痕可以提交给风险
交强险没有报案可以理赔吗	保险可以不提出索赔
交强险如何理赔，任何情况下都赔付么？？？	保险索赔,如何在任何情况下必须支付? ? ? ? ? ? ?
车出事故对方全责第三者受伤对方保险应怎样理赔?	车祸彼此彼此受伤的第三方责任保险索赔应该如何?
我的车和对方的车发生剐蹭，我全责，我只有强险;，对方没有责任。对方有全险。如何理赔？	我的车和另一边的车蹭,我全部责任,我只有强烈的风险;
车辆定损的基本原则是什么	基本原则是什么费用
请问机动车三者险，怎么理赔过程。	你能告诉我这辆车三个风险,索赔过程。
办理转保后1个月内能在外省参保吗	处理后1月内将证实可以在省级人参
保险理赔金按遗嘱前妻可以拿到吗	要求保险公司赔偿了他前妻会
工伤鉴订理赔完后能否向施工方要求赔偿	工伤后的指南书声称可以从承包商要求赔偿
我想问拾级伤残，3500保底工资，是按保底工资吗。陪多少为谢	我想问楼下的残疾,3500底薪,保证工资吗?
如果我离职原因是回家还能办失业保险	如果我辞职的原因是家里也可以申请失业保险
保险在不同公司上了七年了可以领失业险吗	保险在不同的公司七年可以得到失业保险
强制车险为啥只能赔偿70%	强制保险是可以补偿是70%
在外地打工工伤回家农合能报吗	在家里工作一起工伤农夫将引用
在商业保险中豁免中的豁是什么意思	商业保险的豁免和明确的是什么意思
被公司辞退,社保钱可以拿吗	公司被解雇和社会保障资金
新车没有合格证能上三者保险吗？	三个保险的新车没有证书可以吗?
五险一金可以自己申请停吗	五种社会保险和住房公积金可以阻止您的应用程序
车险是按车价还是车的级别	汽车保险是根据汽车或汽车的价格水平
刚上班没几天受了工伤，工伤理赔是否就按本地最低工资赔偿	几天工作工伤,工伤索赔是根据当地最低工资补偿
车辆保险理赔回执弄丢了可以补吗	失去了车辆保险索赔收据可以解决
厂里交了医保,家里要交吗?	工厂的卫生保健,想在家里吗?
星期天离职医保卡会在当天停掉么	周日离开医保卡将会停止
商业三者险，不计免赔，司机疲劳驾驶保险公司给理赔吗？	风险业务,无论特许经营,司机疲劳驾驶保险公司索赔?
我上班时间离职一个月不过保险没有停过我还能享受生育保险吗?	离开一个月,但是我上班时间可以享受生育保险保险没有阻止我吗?
无证驾驶只有强险,肇事,有伤残,怎理赔	无证驾驶只有强烈的风险,事故,残疾,如何索赔
工伤两只手指冲床各冲断了一节，能评为几级，理赔金额是多少	工伤是被两个手指打孔,每个部分可以评为几类,索赔金额是多少
车险定损各家负一半他车定损3000，我6000怎样算	汽车保险费用各负一半的汽车费3000,我6000如何计算
自己开车时倒车把别人的手机压碎了，保险能给赔吗？上的全险，人没事，如果可以赔偿需要什么手续？	当开车回别人的移动破碎、保险支付吗?
社会保俭费个人全部承担退休时如何计算	社会保险节俭的人把所有费用如何计算退休了
车险出险换驾驶员被查出来怎么办	汽车保险或摆脱危险的飞行员发现了如何去做
自杀买意外险，保险公司理赔吗	自杀购买保险,保险公司索赔
在公司上班受伤怎么理赔	在公司工伤索赔
两险和五险医疗报销的区别	差2和5的风险医疗报销
异地车检可以让保险公司代办吗	不同的城市可以让保险公司负责
汽车撞了，直接让定损公司的人修好吗？要注意什么？	被车撞了,直接让费公司修好吗?
新车挂上牌之后还能买三则险吗	新车后悬挂登记也可以买三个风险
买了强保,遇到第三责任怎么办，对方没有年检和保险，都是我赔吗？	买了一个强有力的保护,满足第三责任,其他没有年检和保险,都是我支付吗?
购买下岗保险的员工被裁应走什么程序	购买保险的下岗员工被裁程序应该去
用定额发票保险公司给理赔么	使用定额发票保险公司索赔
机动车保险到期多少日内免于处罚	机动车辆保险在多少天内到期不受惩罚
交强险不在车子的所在地买要贵些吗	保险是没有座位的车去买一些更昂贵
发生车祸后,没有重大伤亡,应怎么赔偿	车祸后,没有重大伤亡,应该如何弥补
交警队赔偿标准与保险公司标准一样吗	交通警察补偿标准和保险公司
公司不办社保不缴纳社会保险费违法吗？	公司不会不缴纳社会保险费的社会保障法律?
护工费是由保险公司出还是由用工单位出	医疗费用由保险公司或雇主
车辆受损后自费维修和走保险维修的区别是什么	在自己的成本和车辆修复受损的区别是什么保险服务
车身停在小区被划痕，保险公司赔吗？	汽车停在村子里尼克,保险公司赔偿吗?
车险提前多久续保	汽车保险提前多久同意了
酒精中毒引起视力严重受损保险公司会理赔吗	酒精中毒导致严重的视力丧失保险公司索赔
刚办社保卡可以享受生育险吗?	只是申请社保卡可以享受生育保险呢?
二次失业可以领失业金吗	二次失业可以申请失业救济人数
我自己把车刮了报车险需要走什么程序	我剃你的车车保险程序所需要的东西
交通事故中损坏大灯在完成理赔之后归属谁	交通事故损坏大灯后完整的索赔属于任何人
车子在下坡自动滑下去撞车了属于理赔范围吗	汽车下坡滑下自动崩溃属于索赔的范围
交强险系统里面生效了。但手续没回来。能开车上路吗	保险制度生效。
车辆理赔完了还能追加吗，拆开后发现大灯裂了	完成车辆后还可以添加它,打开大灯破了
父亲癌症去世子女买爱无优是否给理赔	他的父亲死于癌症的孩子爱是否购买要求
车子买了交强险和商业50万加不记免赔撞了人花了15万自己全责保险公司怎么赔	买汽车保险业务并不是500000年特许人花了150000全部责任保险公司如何输
有驾驶证开没有年检没有保险的车撞人的责任怎么算	没有驾照年检保险车辆撞人的责任如何计算
交通事故责任五五分成，对方医药费两万，我方五千，农村的，该怎样赔付	交通事故责任一半对一半,医疗费用,二万年,五千年,我们的农村,如何支付
我的车是分期付款买的出了事故维修费上万元理赔的钱我怎么拿到	我的车是租购事故索赔维护成本数万元钱怎么走
已使用5年的普通私人轿车须保哪几项保险比较科学，比较经济？	已经使用5年的普通私家车应该确认几个保险更科学、更经济?
个人交养老保险,50岁可以退休吗	个人缴纳养老保险,50岁就可以退休
机票退票险的理赔几天到账，怎么操作	机票退款账户保险索赔几天,如何操作
摩托车保险理赔有哪几个项目	摩托车保险索赔有这几个项目
新车已经办理了保险和临牌,还没有交税能上路吗?	新车已经办理保险和卡片,不纳税在路上吗?
交通事故保险理赔是先结案会不会影响理赔	交通事故保险理赔是第一种情况会影响索赔
交通事故理强制险和评残赔偿可以分开理赔吗	交通事故原因分别强制保险和伤残赔偿可以声称
事故私了后起争议法院判决书能当保险公司理赔的证明	可以解决事故之后,他们争论法院判决时的证明上的保险公司提出索赔
我被车撞了，对方的全部责任，他的第三责任险是理赔30万，我想知道保险公司对这件案子多久有效	我被车撞了,对方的责任,他是危险的责任300000年第三个要求,我想知道多久有效保险公司关于这个情况
领取失业金期间,能申领住房公积金吗	在领取失业福利,可以申请住房公积金
车辆事故对方全责维修费不肯垫付怎么办	交通事故对方只维护成本不支付
什么是私人保险和商业保险？	私人保险和商业保险是什么?
农村户口在外地打工买什么保险比较好	农村户口在购买保险是更好的工作
出租车遮挡车牌出了交通事故，认定我全责，保险公司会理赔吗？	出租车盖板出了交通事故,我只,保险公司索赔吗?
平安保险理赔的拖车费好几天都不给打款	平安保险索赔的拖几天不要给钱
车出现单方小事故,定损已完成,想自己修车，钱没打过来怎么办	汽车出现单方面小事故,费用已经完成,想要自己的车,钱没有回电话
商业保险的住院保险有没返还型的？	医疗保险的商业保险没有返回类型?
年工资缴税影响养老金吗	年薪税收影响养老
商场应该买什么保险	购物中心应该买保险
住过院的可以卖商业保险吗？	医院可以出售商业保险?
请问领失业金的同时,需不需要交保险?	初请失业金人数的同时,需要不需要支付保险吗?
补充商业医疗保险需缴税吗？	补充商业医疗保险来支付税收吗?
学生保险掉了可以补吗补办须要那些证件	学生保险可以让你填满需要这些文档
车放在小区里让人碰了,没注意到,我又开车出去了,过一天了还能报案吗?	让人感动了邻居的车,也没注意,我开车出来,一天也可以报告吗?
单位以解除合同为由可以不补办保险吗	单位为由,取消合同不能补办保险
平煤职工2014年大病保险得癌症能理赔多少	水准标尺什么大病保险可以有癌症声称在2014年
太*洋保险车损理赔需要交维修发票才下款吗	太* CheSun声称需要支付保险服务发票耗尽
撞我的车的一名车主，未按交警和保险公司规定进行理赔怎么办？	撞我的车车主,不按照规定的交警和保险公司索赔吗?
2015年退休事业单位去哪办异地就医手续	2015年退休机构做远程医疗过程
我想问的是像我这种情况是不是属于工伤?	我想问的是像我这种情况属于工伤吗?
非营运中型客车为何不能按非营运投保,如果能保出险给理赔吗?	非经营性中型教练为什么不能盖,根据操作如果给声称可以或者摆脱危险吗?
交通事故发生2年后伤者要我赔偿/我当时的全保还可以有效吗	两年后交通事故受伤的/我完全保险赔偿也同样有效
机动车撞死人，责任对半，需不需要负刑事责任，如果责任对半，保险公司是不是只理赔一半？我的保险最高保	机动车杀人、责任不明确的,需要不需要负刑事责任,如果责任对半,保险公司声称只有一半?
车辆保险赔付伤者不满意怎么办?	车辆保险赔偿受伤的不满意吗?
人身保险有何法律意义?	法人保险是什么?
我车交全险，司机追尾全责，司机死亡保险会赔偿吗	我做了一切险只背后汽车和司机,司机将死亡保险金
保险红利什么时候确定并分配？	当保险红利来确定和分配?
购买机动车商业险有哪些程序与种类	购买机动车业务风险与项目和物种
怎么查在哪个社保点上的保险	如何检查的点社保保险吗
车辆在停车场被该停车场保安打砸应该找谁赔偿，	车辆在停车场停车场安全粉碎谁应该得到补偿,
车祸至人死亡，对方是电动车，责任五成，车子保险100w车损能赔多	车祸死亡,另一种是电动汽车,百分之五十的责任,100 w CheSun可以补偿汽车保险
小学生在课堂上不小心致他人受伤保险公司有赔付吗	小学生在课堂上不小心造成伤害保险公司支付
捷达车全险多少钱	捷达车一切险多少钱
学生险没有报案能补救吗	学生风险没有文件可以做到的
签收保险单时要注意什么？	当签署政策关注?
我人在车里,他人故意扔石头砸我,算故意伤害不	我在车里,他故意向我扔石头,计算故意伤害
刚买的新车撞了，合格证没给，机打发票没给，保险怎么报	刚买了一辆新车,没有给合格证,机器发票没有给,报保险
我开车把人撞到了,别人说他手上带的玉镯子坏了保险公司怎么样赔偿	我开车去打人,别人说,玉手镯摔断了他的保险公司赔偿
厂里给工人买的五险工人需要交多少保险钱	工人在工厂里买五个系统,因此人们需要支付保险金
投资商业养老保险应注意的哪些关键词	什么关键词投资商业养老保险应注意
综保是什么保险	保险是什么
保险理赔会查驾驶证信息吗	保险索赔将检查驾照的信息
生产经营和保险经营的区别是什么?	之间的区别是什么生产和业务和保险业务吗?
六代雅阁交强险和第三方责任险要多少钱	六代协议第三方责任保险和是多少
养劳保险从哪年开始办理	今年来提高劳工保险从开始到处理
干村六年现六十三岁这么买养老保险	干村,六年现在买养老保险是六十三岁
车辆参加保险后车主修车被自己的车压死如何赔付	汽车保险的所有者车库后自己的车如何支付死亡
个人去办养老保险需要带什么证件	个人养老保险需要带什么证件
如何平衡发展传统保险业务与网络保险业务	如何平衡传统保险业务和保险业务的发展网络吗
社区交养老保险男女都到60岁才能退休吗	社区养老保险支付男性和女性60岁退休
社会保险制度的基本要素有哪些	社会保险制度的基本要素是什么
社会保险引发的劳动争议有几种处理方式	劳动争议引起的社会保险有几种治疗
第二年车保险怎么买？	如何购买第二年汽车保险吗?
保单的受益人可以是法定继承人意外的的人吗	保险的受益人可以是法定继承人的事故
谁能解答一下46岁的女士购买哪种商业养老保险比较划算。	谁能回答这位46岁的女人更有利可图的买什么样的商业养老保险。
养老保险能否累积交	养老保险可以累积
投资商业养老保险应注意的哪些关键词	什么关键词投资商业养老保险应注意
为什么要对保险业实行监管	为什么保险监管
理赔和责任认定书必须一起一次性解决吗?	索赔和责任必须区分,一次性解决?
交通事故理维修费一万元车俩未年审交强险能理赔多少?	交通事故的原因都没有采取保险的汽车维护成本一万元可以索赔吗?
给房子买保险有什么好处？	房子购买保险的优点是什么?
今年己经三十多旳农民工怎么买养老保险	今年已经30多一个农民工如何购买养老保险
想买个注重保障的保险买短期的好呀还是买长期的好呀	想买一个注意的安全保险买短期或长期的好啊好啊
我的车辆停在自己家车库失火造成报废怎么获得赔偿？	我的车停在车库火灾导致废赔偿?
交通事故同等责任还要赔付对方的修车费用么	交通事故同等责任和赔偿对方的维修
想买商业养老保险，不要万能保险	想买商业养老保险,万能保险
领取失业金期间养老保险去哪缴纳如何缴纳	如何领取失业救济金期间缴纳养老保险支付吗
已经年满60周岁的男性老人可以买什么养老保险吗	有男人60岁以上的老年人可以买养老保险吗
商业养老保险多少岁买比较合适？哪种好？	多少岁买更合适的商业养老保险吗?
事业单位买了一份职工养老保险,我还想再买一份商业养老保险可以吗?	买了一个职工养老保险,我想买一个商业养老保险可以吗?
车辆在高速碰撞，对方全责，我车有全保，本车保险公司会对我车赔偿吗？	车辆在高速碰撞,对方完全,我有一个全车,违约的保险公司将支付为我的车吗?
生病退职后可以拿赔偿金吗?	辞职后疾病可以赔偿吗?
少儿险、团体险分别有哪些强制性规定	孩子,是什么集团的风险分别强制规定
不看不知道"五险一金"到底怎么用	不知道如何使用“五种社会保险和住房公积金
养老保险补交和正常交有什么区别吗	养老保险待遇和有什么区别正常交货
文通事故中承担全责车辆保险理赔中按比例赔付合理吗	文同事故承担全部责任按比例支付合理的车辆保险索赔
一个用人单位的一个人的劳动保险是多少	一个人在一个用人单位劳动保险得多
兼职人员如何办理工商保险	兼职员工如何处理工业和商业保险
生命人寿保险养老分红型，缴费10年的怎么样？	生命人寿保险养老分红,10年缴费吗?
子女配偶商业保险怎么报销	孩子的配偶商业保险报销
保险中为什么要有绝对免赔率？	为什么绝对特权的保险吗?
给停车场买保险具体包括那些？	去停车场包括那些买保险吗?
海上养殖保险能理赔交通意外吗	海洋水产养殖保险可以声称交通事故
交警无法确定车辆事故责任比例，如何向保险公司索赔？	交通警察不能确定交通事故责任比例,保险公司索赔吗?
社区保险怎么办理	如何处理社会保险吗
机动车保险条例有哪些?	机动车辆保险行为?
责任判定是半责,致一人死亡，50万的车险够赔偿吗	责任判断是一半,一人被杀,500000汽车保险补偿不够
我是受害方,车险理赔车主不报险怎么办	我是一个受害者,汽车保险索赔业主不处于危险之中
一输汽车买了100万元的三者保险万一对方受伤如何理赔	失去汽车购买了100万美元在一千年如何彼此伤害三保险索赔
机动车全险发生交通事故并负全责对当事人有无损害	一切险和机动车交通事故对任何损害当事人承担全部责任
我爸因车祸死亡意外险能赔偿吗	我爸爸可能死于车祸伤亡赔偿
保增长保民生保稳定的意义	增长保护民生的意义保持稳定
高速施救费保险能理赔到多少	高速费保险可以声称多少救援
车祸对方全责，交有50万车险，现我方鉴定为十级伤残，怎么索赔	车祸对方完全,有500000个汽车保险,现在我们确定为十级伤残,如何索赔
财产综合险中的地面塌陷保险理赔手续都有什么？	地面塌陷的财产一切险保险索赔程序都有?
民营工厂买保险需要什么?	民营企业需要购买保险?
保险到期保险公司员工可以代理退保吗	保险代理人由于保险公司员工可以投降
请问在车辆出事后，车辆保险公司已经定损，对方要求另外零件赔偿，协商过但解决不了，有另外的途径吗？	对不起在车祸中,车辆保险公司费用,另从其他部分要求赔偿,协商但不解决,还有另一种方式?
4S店定损后可以去别的维修点修么	4 s店费后可以去其他维修点修理它
两车相撞同等责任对方损坏不大我车损坏修车定损巳达到四万元怎么处理	两辆车相撞彼此相同的责任不损坏我的车损坏修理费用如何处理已达到四万元
自己上了人身保险,被车撞死了,但是他的车也有全险,怎么样赔偿呢?	自己在个人保险,汽车撞死了,但他的车也有风险,如何补偿?
货车被追尾保险怎么处理	如何处理卡车追尾保险吗
大地保险垫付伤者药费要什么手续	支付保险的受伤的过程是什么药
单位不经本人同意，私自给办退休手续合法吗？	单位不同意,给退休手续合法吗?
太平洋保险是否要投保三个月之后生病才可理赔	如果太平洋保险覆盖疾病三个月后索赔
商业养老保险都有哪些？要怎样买？	商业养老保险是什么?
车祸人伤的误工费和护理费等等是由保险公司直接给伤者吗	车祸受伤的工资损失和费用等由保险公司直接向受伤
高速追尾对方全责报案后车修好了能索要赔偿吗	高铁车修好后全部责任报告要求赔偿
保险公司如何运作？	保险公司如何操作?
劳动保险可以个人缴纳费用吗	劳工保险个人缴费吗
从长*把户籍转到西郊医保如何转移	从长*户籍转到卫生保健的西郊如何转移
退社区医疗保险申请怎么写	你写出社区医疗保险应用程序如何
商业保险和学生在学校入的保险冲不冲突？	商业保险和保险的学生在学校到冲不冲突吗?
南*居民医保交了钱可以退吗	韩国可以*居民医疗保健还钱
在外省开电动车摔伤回老家可以报农合吗?	在省电动汽车可以回落到农业还是?
农村医保没有交,会把户口注销了吗?本人现不在家无法交医保，乡镇通知我，他说我不交医保就把我的户口	农村卫生保健没有支付,帐户取消吗?
单位车不买全保,车出了事故该怎么赔	单位的车不买一切险,如何补偿汽车出了事故
补办身份证换照片补办医保卡也换照片吗	补办身份证照片的医保卡也在照片中
邢台的合作医疗在天*住*能报销吗	邢台市天* *的合作医疗能报销
车子出事维修不划算可以申请报废吗	车祸修理不划算可以申请报废
新买的车被别人给刮了，保险公司理赔我不满意,是不是只能法院起诉了…	新买的车被别人刮胡子,保险公司声称我不满意,只有法院……
交通事故，用医保看病，还能申请伤残鉴定吗？	交通事故,使用卫生保健去看医生,你也可以申请伤残鉴定?
灵活就业医保如何取消	灵活就业保险如何取消
保险是国家规定强制性买吗	保险是国家规定强制购买
新农合一家三口人,有一口人是外县的户口在当地能参保险吗?	新农业和三个人,一个人是当地的县的账户得到保险?
对方全责定损后可以要求交警调解吗	交通警察调解后可能需要另收取费用
关于已经参加职工医保的还缴纳农村合作医疗保险吗	关于职工缴纳农村合作医疗保险
交社医保满两年后的生育小孩能保多少?	在社会医疗保险两年后,孩子们可以确认吗?
双车事故中全责方的医疗费和误工费是不是由对方的交强险中赔付	双车事故责任的医疗费用和工资损失从另一边的保险赔偿
汽车出了质量问题保修必须找索赔员？	汽车零部件必须找出质量问题保修索赔?
小事故报案了现场没拍照片保险公司人叫我到快速理赔中心能索赔吗	小事故报告现场没有拍照的人保险公司打电话给我快速沉降中心可以索赔
退出职工养老保险需要怎么做？	职工养老保险需要做什么?
在单位辞职了，当时没办医保，是否能申办居民医保？	退出在单位,没有医疗保险,是否可以竞标居民的卫生保健?
医保卡年底清零吗?能查到去年的刷卡记录么?	在今年年底0医保卡吗?
汽车的电子扇坏了，换了一套新的保险赔不赔	汽车电风扇坏了,换一个新的保险赔不赔
我以前在单位交的医保，现在换单位了，中间有三个月没交，如果以后生病影响报销吗？	我之前支付健康保险的单位,现在在单位,中间三个月不交,如果报销后的不良影响呢?
平安保险汽车大灯赔付标准	平安保险(Ping an insurance)汽车大灯补偿标准
已有社会保险还需要买商业保险吗	现有的社会保险仍然需要购买商业保险
新车在运输过程要上保险吗	新车在运输保险
车辆牌照不变车主变更保险以后有优惠没有	车牌相同所有者更改保险优惠不迟
事故车保险公司认定报废，车怎么处理？我的理赔方法有几种？	废汽车保险公司的事故,一辆车如何处理?
保*市有灵活就业人员只交医疗保险的吗可以吗	保*城市有灵活就业人员,请可以只支付医疗保险
对方负全责,造成人伤该怎么赔偿，除保险公司，对方本人应不应该赔付？	彼此负责任,因为人们伤害如何补偿,除了保险公司,我应该支付另一方?
因交通事故引起的工伤,主责方没钱赔付医药费,社保机构可以出吗	交通事故引起的工伤,主要负责党没有钱来支付医疗费用,社保机构可以出来
太平保险定损跟4S不一致怎么办？	太平保险费用不同意4 s ?
汽车维修发票的额度比保险定损少,保险公司给报销吗?	汽车修理发票金额小于保险费用,保险公司报销吗?
平安保险如果在一个月内宽限期内生病住院还给报销吗	平安保险,如果在一个月内宽限期生病住院报销
汽车被盗了~找保险公司索赔要带些什么证明资料	汽车被偷~找保险公司索赔证明什么信息
买保险能换姓名吗	购买保险可以改变名字
全保第三者保险20W我负全责，10级伤残，保险公司是否全陪	20 w我为一切险的第三方承担全部责任保险,10级伤残,如果保险公司陪
通过汽车维修店办理保险理赔有什么问题么	通过汽车修理车间处理保险索赔有什么问题
保险中为什么要有绝对免赔率？	为什么绝对特权的保险吗?
商业保险有医疗险作为主险卖的吗？	商业保险医疗风险为主要出售吗?
为什么保险为制定商业计划提供帮助	为什么保险提供帮助的商业计划吗
在停车场，我倒车时，将一停靠的车辆，发生互相轻微刮擦，各车各定损150.元。请问该如何理赔	在停车场,我退出的时候,放一个停放的车辆,小划痕,每辆车费用150元。
一辆汽车能上几家保险公司的保险	一辆车可以在几个保险公司保险
分红保险保年限是多少年	分红保险保险周期是多少年
未就业人员医保如何办理	失业人员医疗如何处理
农村农民参加保险的注意事项有哪些？	的注意事项是什么农民参加保险吗?
沈*办理灵活就业医保和城镇职工医保一样吗	沈*灵活就业医疗保险和城镇职工医疗保险
未满十八岁算不算童工，在工厂出了事故要怎么理赔	算不算18岁以下的孩子,出了车祸在工厂如何索赔
保险代理人资格证可以在哪个行业使用？	保险代理人证书可用于哪个行业?
四险一金是交给保险公司还是劳动局的？	四个保险交给保险公司或劳动局吗?
上学放学途中发生意外，学校购买的意外保险，可以理赔吗	偶然在路上从学校学校购买意外保险,可以索赔
介绍一下社会劳动保险	引入社会劳动保险
商业保险断保可以么	商业保险坏了可以么
谁能告诉我临时养老保险缴费是什么意思？与户口有关吗？	谁能告诉我临时养老保险费是什么意思?
在财产保险中，纯费率主要是依据什么来确定。	在财产保险中,纯利率主要是根据什么来确定。
车买了三年了,盗抢险按原价投保,车辆被盗后怎么样赔偿?	买了一辆车三年,被盗保险全价,赔偿车辆被盗?
汽车发生追尾驾驶员受伤应当怎样理赔	汽车撞向司机受伤应该如何说
车祸后强险赔付后第三者的商业保险能不能二次赔偿损失	强劲的风险补偿后的第三方商业保险事故发生后,可以二次损失
车险全保碰了摩托车,人伤势不重,车全责,保险公司咋理赔	所有接触到摩托车,汽车保险受伤不重,汽车,保险公司咋索赔
我买了社保,含住院保险,又买了商业医疗保险	我买了社会保险,医疗保险,买了商业医疗保险
保险公司推定定损什么意思	保险公司认为你是什么意思
汽车定损时没有通知车主怎么办?	当汽车费用没有通知业主吗?
车子全保,把别人腿撞断了,自己大概赔多少	这辆车完全保险,把别人腿断了,可能失去太多
只有交强险的车下年商业险如何买	只有明年商业保险汽车保险如何购买
我坐的摩托车和汽车相撞,汽车负主要责任,我该怎样理赔	我坐摩托车和汽车相撞,主要负责汽车,我怎么说法
车被撞了，走对方的保险，明天去4s店定损，需要怎么办？	被车撞了,他的保险,明天去4 s店费用,需要做什么?
电话保险和直接办的有什么区别	之间的区别是什么电话保险和直接做什么
如何办理超过2000元的互碰理赔	如何处理彼此接触索赔超过2000元吗
每个公民是否一生只能办一种养老保险	如果每一个公民的生活只能做一种养老保险
如何促进失业保险制度的完善？	如何促进完善失业保险制度吗?
车祸之后驾驶员受伤本方保险公司理赔注意事项	车祸后司机受伤的自己的保险公司索赔注意事项
新车子擦破自己去修复可以报保险	新的激怒他的车修复可以报保险
受害人如何申请强制险赔偿	如何申请强制保险赔偿受害者
保险交够5年限提前退保怎么收费	保险待遇足够提前5年,如何收费
出院时职工医保卡里面没钱可以报销吗?	当出院工人健康卡表面没有钱你能报销吗?
网上买商业保险有什么好处？	在线购买商业保险的优势是什么?
为啥中*人就这样不信商业保险？	为什么*人那么不相信商业保险?
我的社会保障卡单位欠缴后停保,我想改成居民医保怎么办	杰出的停止保护我的社保卡单位后,我想改变居民的卫生保健
女职工生育保险究竟怎样保偿法	怎么一个女职工生育保险补偿方法
18岁怎么买保险	18如何买保险
单身女人保险哪种好	单身女性保险是很好的
货车保了双重险理赔能给双重里赔吗?	卡车有双保险索赔补偿的双吗?
公司给员工买保险好还是不好！？	公司给员工买保险好还是坏!
车主全责，事故处理完，车主需在几个月内到保险公司赔偿	业主只,事故处理,业主将支付几个月的保险公司
血管瘤皮肤扩张手术能用城镇医疗保险报销吗	能扩张皮肤血管瘤手术城市医疗保险报销吗
交通事故我方成员十级伤残,对方交强险赔付了,我方还可以找自己的保险公司赔偿吗？	我们的成员,10级伤残,交通事故保险索赔,我们也可以找到自己的保险吗?
太平洋人寿的学平险对于意外是如何理赔的？	太平洋生活学习平风险事故赔偿吗?
贷款买车银行指定地点购买保险合法吗	买车贷款银行指定地点购买保险法律
三轮摩托车不能年审买保险行不行	三轮摩托车不小心不能购买保险
我开小车撞了摩托车，人员受伤第三者怎么理赔，强保怎么赔	我开车撞了摩托车、伤害第三方索赔,如何强保如何补偿
保险保驾驶座位好还是驾驶员好	保险驾驶座位司机更好
请问解放三吨货车第三责任险和交强险要多少钱	请问解放三吨的卡车是多少第三责任保险和保险
包河区户口在单位离职可以自己买养老医疗保险吗,要那些才料谢谢	户口在单位包黄浦江可以离开自己买养老保险,那些只谢谢
能领失业金吗？	初请失业金人数?
喝了酒开车，结果撞在栏杆上了；车撞坏了，保险公司是否会赔偿？买的是商业保险	酒后驾车,结果在栏杆上;
新人做保险，应该怎么起步做啊？？	新人去做保险,应该如何开始?
摩托车行车证年审应交哪些保险?一定要交驾驶员个人险吗?	摩托车注册纸小心应付什么样的保险?
为什么用铁友通不买保险不能买票	为什么使用铁的朋友不买保险不买票
一个家庭拥有多辆车如何购买汽车保险	一个家庭有许多汽车如何购买汽车保险
耕田的手扶拖拉机是不是规定必需买交强险?	犁手扶拖拉机监管需要买保险吗?
车险只上交强好不好	汽车保险就好了
说说人身保险好不好	告诉我一些关于保险的人是好的
为什么进口车好多保险公司都不给上保险？	为什么进口很多保险公司不会给保险吗?
保险中免赔率是什么？	保险将免除可能性是什么?
商业保险与农村合作医疗先报哪一个？	商业保险和农村合作医疗哪一个?
自己买车必须买保险吗?	他们的车必须买保险吗?
保险法的构成主要包括	保险法的构成主要包括
儿童商业医疗保险买哪种好？	商业医疗保险为孩子买什么好?
保险业的售后服务（收展员）与营销员的区别	保险行业售后服务展览(关闭)之间的差异和市场营销人员
021###11是平安保险吗？	021 # # # 11是平安保险吗?
汽车投商业保险车祸受伤住院理赔程序	汽车商业保险在医院意外伤害索赔程序
我的社保是要什么时候去增员呢	当我的社保是去新员工
人们为什么都需要买保险呢？它有什么好处呢？	为什么人们需要买保险吗?
一车货货烧了买了保险保险公司该怎么赔偿？需要什么手续	一辆车货物装运是燃烧买保险保险公司如何补偿?
无证醉驾把人撞成一级伤残植物人保险公司会把强制险12万赔给造事方还是受害人	无证酒后驾车到残疾的水平处于植物人状态,人民保险公司将120000补偿强制保险或受害者
劳务派遣合同到期后，缴纳了失业保险，该怎样办理失业救济金	劳务派遣合同到期,缴纳失业保险,如何应对失业救济金
给孩子买个保险不知道买什么样的较合适	为孩子买保险不知道买什么更合适
在学校受伤如果要求保险公司赔付要多长时间之内有效	在学校受伤如果需要多长时间内有效,要求保险公司支付
大学生城乡居民合作医疗保险是属于商业保险吗?	城乡居民合作医疗保险学院属于商业保险?
太平洋保险公司的车辆商业险是怎么赔偿的	太平洋保险公司汽车业务风险是如何补偿
户口迁出合作医疗怎么交法	RDB的合作医疗
买保险可减个税什么时候开始实施?	购买保险可以减少税收什么时候开始?
女职工生育保险费应由谁承担	女职工生育保险保费应该由谁承担
多级伤残赔偿计算方法？7级伤残是否需要赔偿20年的护理费？	多级残疾补偿计算方法?
交通事故还在处理中又发生事故保险公司会怎么赔偿	交通事故仍在处理和事故保险公司如何弥补
人保车险异地退保的问题	外国的保险投降的危险问题
出租车碰坏房屋,保险公司能赔偿车的修理费吗	出租房屋受损,保险公司可以支付汽车修理
待业人员如何购买保险	失业人员如何买保险
走物流的东西买运费险可以陪付多少	走物流可能购买运费险有多少工资
投保人买了保险出事了中*的保险公司会主动理赔吗	投保人购买保险了意外*的保险公司会主动要求
网上买健康保险不用检查身体吗	不需要检查身体在线购买健康保险
我的社会保障卡以前在社区办理的，现在转正了，单位要让把社保卡注销，重新办，怎么注销啊	我的社保卡在社区处理之前,现在成为正式成员,单位社保卡取消,,如何取消
在健康保险所持有的条款中,主要适用于残疾收入补偿的是什么条款?	在健康保险的条款,主要适用于残疾收入补偿是什么条款?
刚买新车什么都不知道，人保车险续保计算器?到底该怎么办呢？	只是买一辆新车,什么都不知道,保护汽车保险更新计算器?
异地购买太平洋或者新华这样的保险公司的大病保险有问题么	其他购买,如太平洋、新华保险公司购买大病保险的问题
意外骨折保险理赔需要多久才给钱	断裂的事故保险索赔需要多久给钱
去境外工作一般要买哪些保险?商务和劳务有区别吗？	到国外工作一般买什么保险?
28岁女有养老保险和医保,还用买商业保险吗?适合什么样的呢?	28岁的女性有养老保险和医疗保险,还用买商业保险吗?
在追尾事故发生后定损时是否双方必须在场，如一方不在场这个定损算不算数，能不能定	坠机后的费用双方必须存在,如果一方不存在这个费用不算,可以决定
员工手指鉴定是7级，公司要赔付哪些款？	手指识别是一个7级员工,公司将支付支付什么?
尘肺病要交一年的工伤才能签定吗	尘肺病应支付工伤签订一年
国家对单位给个人缴纳劳动保险金额度有何*文规定？	国家单位的个人*劳动保险金额支付吗?
女四十岁开始在单位（私企）交社保合适还是直接买个商业保险？	妇女开始在单位(私人)四十岁时支付社会保障或直接购买商业保险吗?
三轮摩托车的交强险没交会有影响吗？	三轮摩托车保险不交会影响力呢?
高危职业如何购买合适的保险？	如何购买合适的保险高危职业?
肇事方全责学平险保险公司免赔吗？	拉伸仅仅学习平风险保险公司特许经营吗?
社会统筹都有哪些保障?和商业性的保险有何区别?	社会作为一个整体有什么安全吗?
车辆交强险到期被别的车撞了，没买商业险，他的保险能陪吗？	车辆保险到期被其他车撞了,没有买商业保险,保险能陪吗?
车车被撞了报保险多次有影响吗!	被车撞了车保险索赔许多有影响力的!
保险公司报销医疗费为什么要没收医院开的结算单据原件？	为什么保险报销没收医院开放解决原始文件?
摩托车保险过期一年,如年审需交多少钱	摩托车保险过期一年,如小心支付多少钱
没有事故认定书保险怎么报	没有意外保险如何报告
商业保险中的住院医疗这一附加险种能用到多少岁？	商业这个附加住院医疗保险覆盖多大?
劳动能力鉴定不达标有赔偿金吗大慨有多少	有什么损失没有劳动能力鉴定标准多少
大学生办理商业保险需要交哪些资料	大学生应对商业保险需要什么数据
投资分红险的好处和弊端分别有哪些?	有什么优势和劣势分别投资分红保险?
意外伤残鉴定9级肇事司机买了商业险找谁赔付	意外伤残鉴定9买商业保险找谁付钱给司机
都60岁了，单位有退休养老保险，请问还能买什么商业保险？	所有60岁,单位有退休金保险,商业保险也可以买什么?
在农村买了医疗保险，单位上现在也买了，以后怎么报销？	在农村医疗保险,单位也现在购买,如何报销?
请问国家医保参保时不需体检吗？商业保险为何需体检？	国家医疗保险参保没有医疗对不起吗?
刨腹产花了2万多民政局一般报销吗	飞机劳动花费了超过20000民政局一般费用
买了团体意外险伤残五级可以享用吗	买了组伤亡残疾等级5可以享受
新车上路个月，撞上电杆，车严重损坏，,怎么走理赔，	新车在路上一个月,达到极点,车子严重受损,和怎么去索赔,
保险公司出了交强险商业险明年能优惠吗	保险公司的保险业务风险明年可以提供
办理儿童保险要注意什么，	处理孩子的保险应注意什么,
汽车商业险办理还用本人去么	汽车业务风险也要我去
国内货物运输保险的赔偿处理遵循什么原则	国内货物运输保险索赔处理遵循的原则
我小车商业险第三者100万撞路人了。全责，对方请了律师。大概赔偿金额15万。那车主需要出钱吗	我的车100万年第三方业务风险撞到路人。
我要买身体健康的保险买哪种好呢？	我想买医疗保险,买什么好呢?
汽车商业保险报销几次第二年上浮	汽车商业保险报销漂浮几最初的两年
商业保险存折丢了到银行补办需要多长时间	商业保险存折丢失补办需要多长时间
面对新农合，请问商业保险还有没有必要再缴纳？	面对新农民,商业保险,不需要支付吗?
一张身份证能办居民医疗保险和职工医疗保险吗	一个身份证可以做居民医疗保险和职工医疗保险
小孩骨折，两次手术，不够成伤残，保险公司认可最长护理是几个月？	儿童骨折,两个操作,不足以禁用,保险公司批准最长的护理是几个月?
我买的二手车，车险都没过户，怎么交保险	我买二手车,汽车保险转移,如何支付保险
买的二手车强险没过户,自己可以再买一份吗	买二手强有力的风险转移,你可以再次购买
货车没年审吴保险怎么处罚	车不小心保险业务的惩罚
买了两份保险都要原件发票怎么办？	买了两个保险应该是原始发票吗?
今年23岁应该买什么类型的保险	这位23岁的应该买什么类型的保险
85年的人适合买哪种商业保险	人们购买什么样的商业保险在85年
我在单位交了医疗保险,想再参加农村医疗合作保险可以吗？	我在单位做的医疗保险,可以想参加农村医疗合作保险吗?
月薪族适合买什么商业保险？而且对商业保险也不是完全理解	买商业保险的月薪竞选什么?
撞人以后误工费要怎么算	后的钱如何计算
在劳动法中,哪些人群在退休后可以申请社保养老退休金	在劳动法,人们可以申请社会保障退休后养老金
驾照吊销后怎样解除三责险合同	驾照被吊销后如何删除三个主要保险合同
车子被撞坏了保险公司赔偿的钱都会给修车店吗	汽车保险的钱修理车间上撞毁了
摩托车出事保险公司能赔偿多少？	摩托车事故保险公司可以赔偿多少?
被别人骑车撞了,到保险公司要求赔偿要注意什么	被自行车撞了,到保险公司赔偿应注意
人身8级伤害（非工伤）（腰椎)应理赔多少钱？	人8级伤害(伤害)(腰椎)应该理赔多少钱?
机动车碰到电动车怎样陪偿保险赔的的多	机动车运行为电动汽车如何补偿保险支付更多
车辆划痕多了怎么走保险	汽车刮多少保险
车辆第三者保险是什么意思请解答一下	的意义是什么汽车第三者责任保险请回答吗
工伤保险与商业保险的人身意外伤害保险有什么区别？	工伤保险和人身意外伤害保险的商业保险有什么区别?
我想购买人身保险，有重大疾病的健康保险，有这类型的吗？	我想买人寿保险,健康保险,重大疾病类型吗?
企业职工养老保险待遇执行时间?	企业职工养老保险待遇执行时间?
非深户买社保综合医疗，还是商业医疗？为什么？	深户买社保综合医疗,还是商业医疗?
保险理赔主次责任赔偿标准是多少,有明文规定吗	主要和次要责任保险索赔补偿标准是多少,有一个明确的规定
新车没挂牌但对车架号投保了,第二天上牌后出了交通事故,保险公司赔偿吗	新车未列出但覆盖底盘号,登记后的第二天出了交通事故,保险公司赔偿
非农户口的工人，单位按农村户口买的社保，发生工伤后伤残补助金按什么标准赔付	农民工人,单位根据农村户口购买社会保险,按什么标准发生工伤后残疾福利薪酬
16岁，买什么保险好？	16日,买什么保险?
农民工需要买哪些商业保险？	农民工需要购买商业保险?
因故意伤害造成一级伤残，可以要求对方赔偿今后的养老保险么？	故意伤害造成的残疾,可以要求赔偿将来养老保险吗?
大学生医疗保险商业保险能报销看病开药的钱吗？	大学生医疗保险的商业保险支付医生的处方钱吗?
机动车商业保险里的系数指定驾驶员跟理赔有关系吗?	系数的机动车商业保险指定的司机与索赔吗?
购车首次支付的车辆保险费如何记账？	汽车车辆保险费支付第一次如何收费?
买新车分期交的保险跟一次性付全款交的保险是不是不一样	买一个新的租车缴纳保险和支付全额缴纳保险是不同的
经常吃药买什么保险好啊？	经常吃药买什么保险好吗?
大型养鸡场能入保险吗?	大可以养鸡场到保险吗?
给员工上保险每位一年多少钱都包括什么？	员工保险每年多少钱都包括什么?
汽车的保险单找不到了怎么办才好，是大众保险	要做什么,因为我找不到我的汽车保险的政策,是公共保险
补充医疗保险是医疗险还是商业险	补充医疗保险是医疗和商业风险
我爸被车撞了那车只有交强险我爸8级伤残保险公司应赔偿多少钱	我爸爸被车撞了车只有保险我爸爸8级伤残保险公司应该赔偿多少钱
因上班时间更改,无法就业可领失业保险吗?	由于时间的变化,不能就业可以得到失业保险?
车辆行驶过程中因碰撞发生了火灾。给保险公司具什么材料	起火车辆的过程中由于碰撞。
企业养老每个月交一次，需怎样办理？	企业养老金支付每月一次,需要如何处理?
个人自己怎样交养老保险？有什么商业养老保险适合打工人群的？	个人缴纳养老保险吗?
事故一方有交强险另一方没有交强险保险公司如何理赔	对方的一个意外保险不支付保险保险公司如何索赔
自己上三险与商业保险那个更核算?	三个保险和商业保险的核算?
津贴型住院医疗保险费用怎么算	如何计算津贴型住院医疗保险费用
不在护口所在地买保险,回原籍住院怎么报俏	不是在嘴巴位置购买保险,乔一个祖籍在医院如何报告
为职工购买的意外商业保险可否税前扣除？	为员工购买商业保险事故能减免吗?
交强险未过户能得到保险公司赔偿吗？	获得保险保险不能转让?
因打架被公司开除了，可以领取失业保险金吗？	公司解雇,因为战斗后,可以领取失业保险金吗?
目前保险公司针对汽车的划痕险是不是对车主有特别的要求呀？	保险公司的汽车划痕险是否对业主有特殊要求吗?
带薪休假是的年限标准是在单位的工作时间还是工龄？	带薪休假是的生活标准是工作单元或工作的时间吗?
裸车八万，各种手续都算着要多少钱，商业保险可以不买吗？	裸车八万,各种手续要多少钱,商业保险可以不买吗?
到什么部门、如何办理参加社会保险手续？	在什么部门,如何参与社会保险手续?
到什么单位可以办到刻有计划生育办公室或计划生育委员会公章的准生证	是单位能做什么刻有计划生育办公室或计划生育委员会公章ZhunShengZheng
商业保险的大病医疗保险报销后何时能再次申请	商业保险大病医疗保险报销什么时候可以再次申请
右手中间三根都断了一结算几级伤残意外险怎么赔偿	所有中间的三个打破结算几个级别的残疾保险金
大学生商业保险跟医疗保险是自愿的吗	大学生医疗保险和商业保险是自愿的
入了强险和第三者撞死了人判百分之七十赔偿,赔偿受害者24万.保险公司能赔多少	变成一个强大的保险和第三方杀人判百分之七十赔偿,赔偿240000的受害者。
公司注销社会保险后个人再怎么续交？	公司注销后的社会保险个人又如何支付?
我儿子星期天在家出了车祸学校入的保险该怎么赔偿	我的儿子出了车祸在家里周日学校保险如何补偿
晚上遇到车损怎样走快速理赔	晚上见面CheSun如何快速调整
如何进行车辆保险费返还，如何计算？	如何返回车辆保险费,如何计算?
社保能跨省转了吗？要去外地工作3-5年，有必要转保险吗？	社会保障可以跨省吗?
我是新手，汽车总刮刮碰碰，掉漆了，去喷漆得500块钱，我想报保险理赔，理赔之后，明年的保险费会涨吗	我是一个新手,车子总是刮碰,掉漆,油漆500美元,我想报保险索赔,索赔,保费明年将上升
假设买一辆15万元的汽车，车辆购置税要缴纳多少钱啊？现在车辆购置税是%几？谢谢！！	假设150000元买一辆车,车辆购置税支付多少钱?
保险缴费时间与保险合同时间不一样,以哪个为准	保险缴费时间和保险合同时间是不一样的,这为准
撞死人后,死者家属的精神损失费保险公司赔吗	事件发生后,保险公司的赔偿补偿死者家属
两机动车相撞，同等责任，我方车损较大？保险公司如何赔偿？	两个机动车相撞,平等的责任,我们CheSun大吗?
买商业医疗保险之前，需要准备哪些材料呢，麻烦不？	购买商业医疗保险之前,你需要准备什么材料,不麻烦吗?
孩子两岁了，要买什么保险比较适合	孩子两岁,适合买什么保险
保险公司是不是应该按照交警开出的罚单来理赔误工费	保险公司应当根据交通警察发布票索赔的钱
听力职业病九级能赔偿多少？一次性能赔偿多少钱？谢谢	听到这个职业水平9可以补偿多少?
在校期间被车撞到,肇事者赔偿了,保险公司应不应该再赔?	期间的学校,被车撞了,肇事者赔偿,保险公司应该赔偿吗?
无医保的人适合买哪些医疗保险	没有保险的人可以买什么适合医疗保险
如车辆事故需要理赔时交强险不能理赔,商险能正常理赔吗?	需要索赔保险不能索赔,如交通事故、保险索赔正常吗?
外资保险和中资保险哪一个更好？	外资保险和保险中国哪个更好?
小车买保险会登记车辆公里数吗？	车买保险登记车辆里程吗?
车有保险,但是临时牌照过期,请问可以上路吗	汽车保险,但临时许可证到期,请可以上路
是不是在单位自己辞职生育险就木有了	她辞职轴承单元的风险吗
保险车辆的保险金额按低于新车购置价对保险有影响吗	保险车辆保险金额根据不同的新车购置价低于保险
买了社保能不能证明是城市户口	买了社保可以证明是城市户口
保险公司会不会倒闭？商业保险靠谱吗？	保险公司会失败?
车辆事故先报警24小时内报保险公司施救费可否赔偿	交通事故报警首先24小时可以拯救他们保险公司赔偿
国内货物运输保险的保险金额如何确定？	如何确定国内货物运输保险的保险金额吗?
我的车把路人撞了保险公司赔不赔？	我的车被一个路人保险公司赔不赔?
谁知道机动车交通事故责任强制保险单是什么样的？	谁知道机动车交通事故责任强制保险单吗?
商业保险可靠吗？27岁买什么商业保险好？	商业保险是可靠的吗?
肢体2级伤残可以赔付多少钱	残疾的身体2水平能付多少钱
一定要有伤残鉴定才能拿得到交强险吗	必须有一个残疾鉴定得到保险
在工地上班受伤报了工伤,回家后农村小额意外伤害险怎么报	在一个建筑工地工作报告受伤的工伤,回家后农村小意外伤害保险
老家妈妈给我买了农村医疗保险，我还需要买商业医疗保险吗	回家妈妈给我买了一个农村医疗保险,我仍然需要购买商业医疗保险
我的全责，保险公司会给我的车理赔吗?是否可以赔现金	我的全部责任,保险公司会给我车索赔吗?
劳务派遣员工可以在什么地方交保险	劳务派遣员工可以支付保险
农村户口转到城市然后再转回农村还可以用新农合吗	农村户口的城市,然后再回到农村的农民也可以使用一个新的
上户口，做亲子鉴定，钱医疗保险可以报吗	上户口,做亲子鉴定,医疗保险可以提交给钱
商业第三者保险给理赔那些项目？例如：护理费、营养费等	商业第三者责任保险索赔这些项目吗?
五险报销的流程分别是什么？	五个保险报销流程是什么?
车子蹭成这样需要走保险吗？黑漆都蹭掉一块，	车擦到这种保险需要吗?
公司货车在装货中被插车撞碎挡风玻璃保险公司赔吗	公司卡车破碎的挡风玻璃是插在装载车辆保险公司赔偿
汽车主险和附加险是保险期内每次事故都赔偿吗	车是主险和附加险保险期间每一事故赔偿
母亲50岁，上平安什么保险好？注重保障型，保费便宜	什么是好的保险母亲50,和平?
医疗保险有什么用，每个月扣的钱和打进医保卡里的一样的	使用医疗保险,每个月扣钱和医疗保险卡相同的
请问小孩在上学的路上出了车祸,鉴定为十级伤残,学校的保险是怎样理赔的	对不起这个孩子在上学的路上发生了意外,鉴定为十级伤残,学校的保险索赔
我的车第二年了，都买什么保险好呢？？	第二年我的车,买什么保险?
交强险垫付到医院没用完得钱还需退还给保险公司吗	没有给到医院保险的支付更多的钱需要返回到保险公司吗
长期出差外面适合买什么保险	长期出差在外面买什么保险
农保和商业险有没有冲突	农业保险和商业保险如果有任何冲突
我开车撞坏别人的车和车上的货物，保险公司可以理赔吗	我是开别人的车,撞汽车产品,保险公司可以索赔
外地养老保险转回石门	外地养老保险石门
买保险应该注意什么？	买保险应该注意什么?
生育津贴，单位是否可发可不发？	生育津贴,单位可以发不发?
我想给鸡买保险,怎么买?我想给鸡买保险,怎么买?	鸡,我想买保险如何买房?
事故之后车子没有修好，保险公司已经结案，请问我现在还可以要求保险公司重新定损修车吗？	不是修理在车祸后,保险公司已经关闭了,我现在可以要求保险公司修理费用?
医疗保险和大病统筹保险一样吗？办理需要什么手续	医疗保险和重大疾病保险作为一个整体?
什么是保险中所说的“额外给付重疾”？	什么是“额外支付沉重的疾病”的保险吗?
财产险如何理赔没有发票的财产能得到赔偿吗	财产的财产索赔没有发票如何得到补偿
我无交强险与有交强险相撞保险公司怎样赔偿	我没有保险与综合保险公司如何声称相撞
商业保险索赔有无期限？	商业保险索赔下去吗?
车子报保险维修要去公安局报案吗	汽车保险服务到公安局报告
车险受损第三方可直接向保险公司索赔吗？	汽车保险损害第三方可以直接向保险公司索赔吗?
买保险必须本人签名吗	必须买保险我的签名吗
辞职后可以退保吗	辞职后投降
汽车保险怎么买最划算	如何买最便宜的汽车保险吗
机动车第三者责任险费率浮动制度有哪些内容？	机动车第三者责任保险费率浮动系统什么内容?
孩子有了学平险还需要买其他的商业儿童医疗保险吗？	孩子已经学会了平坦的风险仍然需要购买其他商业儿童健康保险吗?
摩托车交强险出了交通事故保险公司最大限额赔偿多少？对方没有死亡鉴定十级伤残，	摩托车保险的最大交通事故保险公司赔偿吗?
座位险骨折赔偿务工是出院了就不给了还是一直给到恢复好了	座位骨折风险补偿工人出院了没有给或得到恢复好
汽车保险怎样理赔，理赔是多少，理赔率是多少，谢谢	多少是汽车保险索赔,索赔,几率是多少,谢谢
怎么样才能知道单位有没有给我们交养老保险呢？	如何知道是否有单位缴纳养老保险?
自己开车发生车祸出了人命,保险公司怎样理赔	开车在一次车祸中了致命的保险公司如何索赔
无医疗保险的中年人适合买什么样的商业医疗保险	没有医疗保险适用于中年人买什么样的商业医疗保险
开车的时候碰到了石头，车门下方碰了个浅坑，这属于车损险么，保险公司理赔么？	开车时遇到的石头,下面门碰浅坑,这属于保险,保险公司索赔?
货物运输保险费是怎么计算的？	货物运输保险费是怎么计算的?
派遣工上班途中自己摔伤了，公司买了保住院怎么报销？	送工人去工作的路上他受伤,公司买了酒保在医院如何报销?
保险涉及车损一人死亡,一人受伤需要什么理赔资料	保险涉及CheSun一人死亡和受伤的另一个索赔信息的需要
商业养老保险和社会养老保险的区别有哪些？哪种好？	商业养老保险,社会养老保险的区别是什么?
私家车要买强制险,第三者责任险,划痕险要多少钱	私家车购买强制保险、第三者责任保险,尼克是多少
我妈59岁.买阳光保险防癌险,需要每年多少钱?	我的母亲59。
车辆受损保险公司如何计算需要赔付的修车件价格	如何计算车辆损失保险公司需要支付维修配件价格吗
职工生育保险申请表内的产假要写多少天是不是越多越好	职工生育保险申请表应写多少天的产假是越多越好
极短期意外伤害保险是多短,一两天吗？	非常短期意外伤害保险更短,一两天吗?
在厂里烧伤意外保险赔偿金归谁享受	烧伤事故保险金享受在工厂吗
驾车闯红灯受伤，购买了商业人身意外意外保险可以赔偿吗？	开车闯红灯被伤害,买了一个商业人身意外保险可以补偿吗?
新型农村医疗保险，重疾可以报销吧？	你可以报销新农村医疗保险,严重的疾病吗?
买了三年的保险不想买了，可以退款吗	买保险三年不想买,可以退款
农用车入什么保险好，我要入保险	农业保险是好的,我想入保险
小孩老是生病要住院适合买哪种保险?小孩住院买什么保险好?	你想要什么样的保险医院购买孩子们总是生病吗?
交强险可以延迟购买吗？	保险可以推迟购买吗?
15年城镇低保家庭怎样补交养老保险金	15年城市低收入家庭如何缴纳养老保险金
农合参保是以个人名义加入吗	农民加入和加入自己的名字
工厂违约工人能否拿到工龄补偿及失业保险	工厂工人可以默认长度补偿和失业保险
退休后，剩在医保卡里的钱咋办？	退休后,钱已经离开的医保卡吗?
66岁打工受伤九级伤残该怎样赔偿?	66岁的工作受伤的9级伤残如何索赔?
什么是万能型保险？	万能保险是什么?
57岁老人适合买什么商业保险	57岁的购买商业保险
企业医保转零活就业需要什么手续	企业的健康工作就业需要什么手续
有精神病有残疾证可以买商业保险吗?	有精神残疾可以买商业保险吗?
财产一切险能算是商业保险吗？	财产一切险可以商业保险?
外*户籍在中*重大疾病保险需要准备什么?	从* *外重大疾病保险需要准备吗?
我的车刚碰着出了一次险隔了两天又撞着了保险公司还出吗	我只是触摸汽车触及每两天风险,保险公司仍然
农村合作医疗是医保吗	农村合作医疗覆盖率
社保可以办2份吗？	社会保障可以做2份?
存款保险条例所称存款保险是指什么	存款保险法案,术语“存款保险是指
养老保险交满15年后继续交如何分配养老保险金？	养老保险缴纳满15年继续缴纳如何分配养老保险?
车祸当时只报交强险没报伤残,可以后报吗	交通事故不仅是提交给保险残疾,后可以报价
意外保险理陪报上去后，需要好久能拿到保险金。	意外保险原则后,需要很长时间才能得到保险金。
五险一金是上好？还是不上好？	五种社会保险和住房公积金是好吗?
用人单位买工伤保险最高可赔六十万包括医药费吗	用人单位工伤保险购买最多六十万包括医疗费用补偿
怎么农保越交越多了今年一百二十元一人了这个数是国家规定的吗	如何支付越来越多的农业维持一百二十元今年的几个国家规定的吗
公司为员工购买人身意外伤害保险，保险如何理赔？	公司为员工购买人身意外伤害保险,保险索赔?
买商业保险领取生存金是什么意思	你什么意思购买商业保险为生存金
我的车和别人的车撞了保险公司怎么个赔法	我的车和其他车撞了保险公司如何补偿方法
社保和商业大病医疗保险有冲突吗	社会保险和商业大病医疗保险有冲突
交通事故脸部多条伤疤,但未达到伤残级别,保险公司应不应该赔付后期治疗费用	交通事故比面部疤痕,但没有达到的水平残疾,保险公司应该赔偿支付后期治疗
旅游在不同的保险公司购买保险是几个公司都能赔付？	旅游在不同的保险公司有一些公司可以购买保险来支付吗?
类似社会医疗保险的商业保险险种，谁给具体介绍几种？	类似的社会医疗保险的商业保险,具体介绍几种谁?
如果我今年的车损险是按新车购置价来定的保费，那么明年呢？	如果我今年的报道是根据新车购置价保险费,那么明年呢?
生育保险备案要多久能生效	要多长时间才能生育保险备案生效吗
有商业保险,还能交社会社会保吗	与商业保险,也可以支付社会社会保险
在公司上班受伤不能干活公司赔损失吗?	在公司工伤不能公司赔偿损失吗?
我的车子没有年检，但是买了保险有效吗？如果被抓会罚多少钱？	我的车没有年检,但买保险的工作吗?
交24年劳动保险了,不交了行吗?需要什么证名办手续	交劳动保险的24年,不是吗?
出险看病费用哪些不能保险理赔	或摆脱危险的治疗费用,不保险索赔
汽车追尾事故没造成严重后果可否要求保险公司现金赔偿	交通事故没有造成严重的后果可以向保险公司要求赔偿的现金
大病保险的赔款是完全由商业保险公司赔还是政府和它一起赔？	大病保险赔偿是完全由商业保险公司或政府补偿支付吗?
既然交强险有浮动费率的制度，那商业险有吗？	自保险浮动汇率系统,业务风险?
境外个人可以在境内买保险吗	在中国外国个人可以购买保险
交强险对精神抚慰金怎么赔偿	情绪困扰的保险金
新车临时号牌期间被盗抢保险公司赔不赔	新汽车被盗期间临时板保险公司不赔偿补偿
目前商业保险有和社保中的医疗保险类似的吗?	当前医疗保险的商业保险和社会保险的类似吗?
车辆买的有商业险,还一定要买交强险吗?	车辆购买商业保险,但也必须买保险吗?
如果车报废了，入的全保能转到新车上吗？还是可以退啊？	如果汽车,所有的风险都可以转移到一辆新车吗?
在犹豫期退保了保险公司发来信息说三至七天钱能到帐是真的吗?	投降的犹豫期从三到七天保险公司信息到账户的钱是真的吗?
老年人重大疾病保险如何？老年人商业保险如何分类？	旧的重大疾病保险吗?
车强险应该如何赔付？商业保险又是什么？	强大的汽车保险应该如何付款?
投了意外伤害险被摩托车撞后如何向保险公司索赔	意外伤害保险的保险公司索赔后被摩托车撞了
保险公司不赔保怎么办	保险公司不支付保险
汽车消费贷款保证保险的保险费率如何确定	如何确定汽车贷款保证保险的保险费率吗
车辆没有商业保险应该受到什么行政处罚？	没有商业车辆保险行政处罚应当是什么?
买了保险,发生事故,签定十级和八级伤残应赔多少钱	买了保险,事故,十级的签署和8残疾应该补偿多少钱
出事故车在停车场了耽误验车保险公司给赔偿金吗	事故车在停车场延迟测试汽车保险公司赔偿
老板帮职工买商业意外保险给谁赔付	老板为员工购买商业意外保险赔偿
新汽车购置发票数字开多开少对保险有什么关系	新车购买发票开放不开放保险数量之间的关系是什么
大车全险的话如果撞死了人是保险公司赔钱还是自己赔钱	车一切险如果杀了一个保险公司赔钱或亏损
身份证过期了还能报销合作医疗吗?	身份证过期了合作医疗能报销吗?
车子出险后伤者起诉我要求定伤残等级我是全责对我有什么害处	汽车后或摆脱危险的伤员起诉我问将禁用评分仅仅是伤害我
个人缴纳养老，医疗保险要到哪里去交	个人缴纳养老、医疗保险支付
2万元左右的定损保险公司能赔多少	20000元费用保险公司会赔多少
汽车商业保险和强制保险有什么区别	之间的区别是什么汽车商业保险和强制保险吗
商业保险与常住地区有关系吗	保险的商业和住宅领域的关系
法院是否有权调解劳动纠纷中的养老保险问题?	法院是否有权劳动争议调解的养老保险问题?
保险有没有有一次性付款交齐,每月按时发工资的险种	保险有一次性付款气、每月保险工资准时吗
公司帮工人交五险是那五险？工人需要准备什么？	公司帮助员工支付5五个风险吗?
平安金彩人生两全这种保险年收益肯定比定存年收益高吗？	保险金生活平安满意的年收入高于存款账户年度收入吗?
货物保险中，什么是代位请求赔偿权及其效力？	货物保险,购买代和其有效性是什么?
小学生学校受伤被鉴定八级伤残是叫保险公司赔钱吗	小学损伤识别8残疾叫保险公司赔钱
金佑人生保险,如果一生中有过理赔了到老了还能领养老金不?	金你的人寿保险,如果生活索赔旧可以得到养老金吗?
泰康人寿可以审请二次理赔吗?	泰康人寿可以申请二级结算?
投保中*人寿意外伤害险，被人打伤了，能不能得到理赔	*生活事故风险,受伤,可以索赔
投保后在国外发生保险事故，保险公司是否赔付？	国外保险保险事故发生后,保险公司支付?
妇女防癌保险在平安保险公司怎么买	女性的癌症在平安保险公司如何购买保险
为什么投保的时候保单上的车价比实际高呢	当为什么保险价格高于实际的政策
在一个事故中，有多个受害者。保险公司如何赔付呢？	在一次事故中,有多个受害者。
如果一个人有了公司的团体意外险，还有必要购买个人意外险吗？	如果一个人有保险公司,需要购买人身意外保险?
华夏财富一号两全保险万能型c款的钱取不出来，怎么投拆	华夏财富养老保险1号通用型c钱取不出来,如何投诉
酒精含量百分之二十八保险公司理赔吗？	酒精含量百分之二十八的保险公司索赔?
买寿险，那个保险公司最好？那种产品好？	百思买人寿保险,保险公司?
商场买财产保险,如果遭到人为破坏,怎样索赔	购物中心购买财产保险,如果人为的破坏,如何索赔
只交养老保险和医疗保险的能领失业金吗	只能领取失业缴纳养老保险和医疗保险
农保未交够十五年可以退钱吗	农业保险15年没有支付足够的可以退款
存了一万元在新华保险红双喜,人死了能赔偿多少	存了一万元在新华保险双喜,死也不能弥补多少
平安鑫利两全保险（分红型）和平安智慧星终身寿险（万能险）都有什么权益？	鑫平安养老保险(分红)和平安明星ji-hye一生(通用)有权利吗?
撞了一个孩子,未造成伤残,单位买了第三方责任险,还需要私人赔钱吗	打一个孩子,没有造成残疾,购买第三方责任保险单位,也需要私人资金
车龄损失费计算	旧的损失计算
我没有农村合作医辽,生小孩有补贴吗	我没有农村合作医疗辽、儿童补贴
保险犹豫期怎么算的？急！	保险犹豫时间如何计算?
借款人人身意外伤害基本保险赔偿	借款人人身意外伤害保险的基本补偿
请问平安车险理赔系统与人保车险理赔系统有什么区别？	汽车保险理赔系统和维护和平,请汽车保险索赔系统的区别是什么?
车祸赔付是由保险公司直接赔付给伤者吗？	事故赔偿是由保险公司直接支付的受伤吗?
我亲人喝酒醉死只买了车险和工伤保险请问可以找他们理赔吗？	我喝酒喝死的亲戚只有买了汽车保险和工伤保险是能够找到他们的要求吗?
去年9月交的社保12月生的孩子可以报销吗?	去年9月支付社会保障的儿童出生至12月可以报销吗?
养老保险怎么自己查询缴费了吗？	养老保险如何查询过期?
养老保险每年缴四千十五年后收益是多少	养老保险是多少四千零五年之后每年收益支付吗
脱保一个月现在刚交了保险,请问是立即生效吗?续交后出了事故保险公司还管吗?	TuoBao现在仅仅一个月交保险,是立即生效,好吗?
80岁以上老人农保转社保是否可以	超过80岁的农民可以将社会保障
公司和个人缴纳养老保险15年后可以不交了么？公司会把不交的养老保险每个月给我们吗？	公司和个人缴纳养老保险15年之后,不能做的?
公司名义购买员工团体保险赔付金打到谁的账号	公司员工集体保险的名义支付到账户
什么样的理财产品适合家庭主妇，没有收入，没有任何社保、保险？？	什么样的产品适合家庭主妇,没有收入,没有社会保障,保险? ?
购买水车摩托车买了保险上了牌，请问保险生效吗？	水车摩托车购买保险卡,请问保险生效?
平安人寿保险怎么还贷款利息	平安人寿保险怎么还贷款利息
我忘记交今年的一老一小保险了,怎么办？现在交还来得及吗？	我忘记支付今年一个古老的小保险,怎么办?
怎么样才能知道自己的医保卡上有没有生育保险？	如何知道他们的生育保险医疗保险卡吗?
住院津贴险和住院医疗险有什么区别？	之间的区别是什么住院津贴保险和医院卫生保健?
农村合作医疗可以一个人一个人的交吗	农村合作医疗是一个人的手
车子报险,保险公司不派人处理怎么办？	汽车面临风险,保险公司不派人处理?
请问学生投保太平洋保险被狗咬是否可以理赔?怎么理赔?	同学,请确保太平洋保险被狗咬伤可以索赔?
单方事故，相关手续齐全，太平洋保险公司不按规定理赔，怎么办？	单边事故,完成相关手续,太平洋保险公司不依照本法规定,索赔,怎么办?
出事故后，保险公司在赔偿护理费和营养费是什么标准？补充一下，伤者家人护理和专业护理有区别吗？	发生事故后,保险公司在赔偿费用和这些款项是什么标准?
飞机延误如何索要赔偿？购票时有购买延误险~延误四个半小时~春秋航空~非天气原因延误~	飞机延迟要求赔偿吗?
如何为父母买医疗保险？	为父母购买医疗保险?
换城市工作,医疗保险是不是要重新缴纳	工作在城市,医疗保险应该再次支付
不计免赔特约险是什么责任都赔偿吗	无论什么危险的特约避免补偿赔偿责任
商业医疗保险和社保医疗保险报销时冲突吗？	商业医疗保险和社会医疗保险报销冲突?
商业补充医疗保险个人可以买吗？还是必须通过企业才能购买？	商业补充医疗保险个人可以买?
生育险是不是必须要在现单位购买满一年才可以报销呢？	生育保险是必须在目前的单位购买满一年报销吗?
异地可以买保险吗？	长途可以买保险吗?
生育保险报销是不是要产假过完	生育保险报销后产假
请问，汽车发动机特别损失险是不是就是涉水损失险?	对不起,汽车发动机特别损失险是涉水损失险?
个人买商业保险划算吗？还有就是买社保好呀？	人们购买商业保险?
工伤保险和意外伤害保险有何区别啊？	有什么区别工伤保险和意外伤害保险吗?
辞职后，养老保险如果不转移会怎么样	辞职后,养老保险转移
公司交五险一金,那么家里(农村)医保什么的还用不用交?	公司支付五种社会保险和住房公积金,所以回家(农村)卫生保健仍然使用不需要支付什么?
我车被别人追尾了，对方全责，对方保险公司定损满足不了我的要求，该怎么办	我的车被别人追尾,另一方只,保险公司不能满足我的要求,我应该做什么
家用车只买交强险可以吗？	家庭汽车只可以买保险吗?
家用小汽车交不交车船税？每年都得交吗？	不给你车家用汽车吗?
办理医保住院手续需要带什么证件	在医院医疗手续需要带什么证件
没有工作单位自有职业，怎么交养老保险，什么时候交	没有工作单位有自己的职业,如何缴纳养老保险,当支付
产假期间的保险，是个人全部承担？还是该公司承担的公司承担，个人只需要缴纳个人承担的就可以？	把所有产假保险,是一个人吗?
交车船税要带什么证明资料、该怎么交？	将支付汽车带什么证明材料,如何支付?
买保险,一定要找代理人吗,直接去保险公司买不可以吗?	购买保险,你必须找到代理,不能直接向保险公司购买吗?
如果我同时买了新农合和商业医疗保险，是不是可以同时报销的？	同时如果我买新的农业和商业医疗保险,同时可以报销吗?
外籍人士可以买中*保险吗？	外国人可以购买保险吗?
单位变更,领生育保险证明怎么写?	你如何编写单元变化,得到生育保险证书?
我的车撞了别人的车,我负全责,保险公司该怎样理赔?	我的车撞了别人的车,我承担全部责任,保险公司如何索赔?
脑动脉瘤是否属于良性脑肿瘤?是否符合保*会规定的重大疾病？保险公司赔不赔？	脑动脉瘤是良性脑瘤?
可不可以给手机买保险？	我可以买手机保险吗?
私家车能否只购买交强险而不买商业险	私家车不仅可以购买保险,但买商业保险
第三者责任险保30万还是50万，有什么区别吗？	第三方责任保险,以保护300000或500000,有什么区别呢?
公司商业保险报销能报销检查费用吗	商业保险公司赔偿可以报销来检查
车船税可以跨年交吗？不及时交的话会不会有滞纳金？	车辆和新年是吗?
我国设立保险公司，注册资本最底是多少	建立我国保险公司,注册资本是多少的底部
中国人保财险一年出两次险第二年保费怎么算?	中国保险公司一年两次的风险在第二年的保险费用如何计算?
运费险怎么用啊？我已经投保了	货运保险如何使用?
4S店定损和保险公司定损哪个好	4 s店好费和保险公司
修车花费六百元有没有必要走保险啊	如果有任何需要汽车保险费用六百元
下雨天车发动机进水，想要保险理赔有什么解决方法	汽车发动机进气在雨天,想保险索赔的解决方案
新手，如果出了交通事故走保险，先报保险公司，如果责任明确是对方责任，是不是他们报保险公司	新手,如果出了交通事故保险,首先提交给保险公司,如果责任是明确责任,如果他们提交给保险公司
车辆剐蹭保险理赔程序怎么走？	交通事故曾保险索赔手续?
建筑工如何买意外保险	建筑工人如何购买意外保险
摩托车被偷了,上牌时买了保险,可以索赔吗?	摩托车被盗,买了保险在注册过程中,您可以索赔?
50岁以上的男性买什么保险	50岁以上的人买什么保险
建筑工程一切险的理赔范围有哪些，是否每个工程保险条款都相同？	建筑工程一切险的报道什么,每个工程保险条款是否都是一样的吗?
加入城镇职工医疗保险是否还应购买重大疾病保险	参加城镇职工医疗保险是否也应该购买重大疾病保险
公司给员工购买保险是必须5种保险都买吗?还是不用买全	公司买保险是必须买5种保险?
我车子被别人撞了别人报保险赔了我我还可以报自己保险赔自己的车子吗	我的车被别人别人报保险补偿我我也可以报保险补偿自己的汽车
新车购置税怎么交	买家如何
商业医疗保险报销程序?	商业医疗保险报销程序?
职工生育保险待遇申请表怎么填写	职工生育保险待遇填写申请表
领取失业保险金过期限怎么办?谁负责,?有什么法律依据吗?	后领取失业保险金期限?
哪种商业保险可以报销生育费用	什么样的商业保险可以报销生育
通过保险代理公司买保险有什么好处？	的优势是什么,通过保险代理人购买保险吗?
撞车我全责保险公司花钱修好了，我需要额外给对方现金吗？	崩溃我花修复全部责任保险公司,另一边我需要额外的现金吗?
大学生医疗保险和大学生意外伤害保险（学平险）有什么区别？	大学生大学生医疗保险和意外伤害保险(风险研究平)有什么区别?
个人全额交养老保险划算吗	个人全额缴纳养老保险负担得起的
我工作10年能领取多少失业金,失业金是一次性领取么？	我工作十年能接收多少失业救济金,失业救济金是一次性得到了什么?
买机票就带保险了吗？还是需要额外自己买保险，有什么单据吗？	买机票和保险吗?
保险防灾防损的含义是什么？有哪些这样方法	的意义是什么防灾安全保险吗?
买商业医疗保险之前是不是要花很大一笔钱做体检	在购买商业医疗保险是要花很多钱用于医疗检查
上一年的汽车强制保险标志还有没有用啊！我弄掉了怕还有用	去年的汽车强制保险标志和没有使用!
买重大疾病保险，买10年保20年的好，还是买20年保80年的好	购买重大疾病保险,10年保养的好,20年或20年80年好
生育保险一次性补清一年的缴费之后能享受医疗保险待遇吗	生育保险一次性填满一年后支付清可以享受医疗保险待遇
50岁以上商业养老保险哪种好	50多个商业养老保险非常好
新华保险的福如东海什么保险啊？	什么幸福一样巨大的东海新华保险保险吗?
商业险和强制险不是同一个保险公司,没关系么	商业保险和强制保险保险公司不一样,没关系
社保中的医疗部分保什么?和商业保险中的意外险有无重合的地方？	医疗社会保障保险的一部分?
农村户口交成城镇社保怎么办？可以正常退吗？	农村户口在城市社会保障支付吗?
太平洋保险给在学校的学生做的保险承保的范围有哪些呢？	太平洋保险为学生在学校保险的范围是什么?
自由职业者,创业者如何购买生育保险?如何办理生育保险?生育保险的规定是什么?社区办理的要求？	自由职业者,企业家如何购买生育保险吗?
如果想通过车辆保险给车重新全车喷漆，一般应该怎么做？	如果你想要通过汽车保险汽车车漆,一般应该做什么?
做保险好吗？	有保险吗?
社保和商业大病医疗保险有冲突吗	社会保险和商业大病医疗保险有冲突
保险公估人怎么样？就业前景怎么？	保险评估员吗?
新华保险康健吉顺合同到期退换保险费吗？	新华保险适合JiShun合同退还保险费?
哪种商业保险能报销门诊费用的？？	什么样的商业保险可以报销门诊吗? ?
中国平安保险公司的钟爱一生条款是怎样的？	中国平安保险公司的爱什么样的生活方式?
意外伤残保险公司如何赔偿？意外伤残的赔付比例是多少？	如何弥补意外残疾保险公司吗?
公司替员工办理三险一金的流程是怎样的？	公司帮助员工处理三个保险的流程是什么?
交强险和商业险能分开保吗？	保险和商业保险可以保护分别吗?
保险销售技巧	保险销售技巧
下岗职工怎么买医保?	下岗工人如何购买健康保险?
学生保险理赔申请书怎么写，	学生保险索赔应用程序怎么写,
盗抢险有必要买吗？如何购买盗抢险比较划算？	被盗有必要买吗?
自费出院后单位交的医疗保险还能报销吗？怎么报销？	自费出院后单位支付医疗保险可以报销吗?
住院之前没有出示医保卡。如何办理报销。	之前没有出示医疗保险住院治疗。
我的车被撞了对方全责但我的保险以过期对方还会理赔吗	但我我的车受到全部责任保险日期彼此会索赔
如何发展我国银行保险业务	如何发展我国银行保险业务
网上怎么买汽车保险	如何在网上买汽车保险吗
交强险中，伤而未残，误工费这么赔付	保险,受伤没有剩余,失去工资支付
企业最低给员工交多少保险?个人交多少,公司交多少?	公司给员工支付的最低保险吗?
请问“无责代赔”到底是什么，搞得我不能全额拿到保险赔付？	请问什么“没有责任赔偿”,充分我不能得到保险赔偿?
商业保险和补充医疗哪个好呢？	商业保险和补充医疗好吗?
买了50万的第三者责任险，出了事故，造成对方死亡的，保险公司肯定会赔50万？需要自己掏钱吗？	买了500000的第三方责任保险,事故造成的死亡,保险公司会赔500000 ?
车险上的三者是30万的，把别人车撞坏了，需要赔偿50万，怎么办	的三个汽车保险是300000,别人撞了车,需要支付500000,如何去做
人保车险，停车场蹭到别的车，人保是不是要求交警过来，快速理赔怎么走？	危险,汽车保险,碰到另一辆车停车,危险是请求交警过来,快速调整怎么走吗?
怎么才能从网上查自己医保卡里还剩多少钱?	我怎么能上网查医保卡还剩下多少钱?
想看牙，是否有牙病医保？	想看牙齿,是否有牙齿健康?
商业医疗保险一年多少钱？	商业健康保险一年多少钱?
异地买保险好吗？	异地购买保险吗?
平安保险公司车险理赔是不是按定损时的金额全额赔付	平安保险公司汽车保险索赔根据费用全额支付
我的车子买了强制险和20W的第三者责任险!我现在撞了人,伤的比较轻.我能得到全部赔付吗?	我的车买20 w的强制保险和第三者责任保险!
驾驶员驾驶他人车辆被甩出车外死亡交强险怎么赔付	汽车驾驶人被排除在外的车死亡保险如何缴纳
商业医疗保险报销比例是多少？怎么报销的？	商业医疗保险报销比例是多少?
保险的真正含义是什么	保险的真谛是什么
充分就业时允许存在的失业有哪些	什么是允许的过程中充分就业失业吗
医保不同城市转移需要那些手续	转移的过程需要卫生保健在不同的城市
为什么农村户口不能办医疗保险	为什么一个农村户口不能健康保险
在外地上班交了医保,老家还要交新农村合作医疗吗	室外工作移交医疗保健,使新型农村合作医疗
保险兼业代理属于什么行业	保险兼业代理机构属于什么行业
2015年车辆被撞，对方全责我车刚刚买，损失严重我可以要求赔折旧费吗？	汽车是在2015年,另一方只我的车刚买,我可以要求赔偿折旧费损失严重吗?
未成年人要买保险吗	未成年人购买保险
自由职业办理养老保险是否划算	养老保险的自由是划算的
汽车被别的车刮了跑了如何理赔，怎么报保险	车被另一辆车刮跑如何索赔,保险索赔
回家发现后视镜撞坏了，只交了交强险，怎么能用保险修车？	回家发现后视镜坠毁,只支付保险,如何使用汽车保险吗?
致驾驶员死亡的单方事故保险公司是否应该理赔	杀死司机应该单方面事故保险公司索赔
新*停*区不知被哪个混蛋刮花了如何处理	新* *停止区域不知道是哪个混蛋挠
重新安装的倒车镜刮花平安保险公司赔吗？报的是全险	重新安装镜子挠平安保险公司赔偿吗?
车子出了事故，开到4S店，保险公司要来先做定损？	汽车出了事故,开车4 s店,保险公司在第一个要收费吗?
我是刚入保险行业的新人,职业规划该怎么写?	我只是在保险行业,职业规划怎么写?
商业的养老保险分哪几种？怎么上呢？	什么样的商业养老保险点?
第三方责任险和不计免赔险撞人了怎么算	第三方责任保险和到一个人如何计算不包括特许经营风险
小汽车被单车撞了，我买了全险，怎么保险公司不理赔	车子被自行车撞了。
汽车出险经过怎么写	汽车是如何编写后或者摆脱危险
别人的汽车买保险，用我的身份证可以吗？	人们购买汽车保险,用我的身份证可以吗?
第三方责任险中的第三方到底是什么感念？比如说，我开车撞伤人了，交警认定是我的责任。	第三方第三方责任保险的概念是什么?
我走保险给对方修车是否一定要走对方指定4S店修理？	我是否去其他汽车保险必须去另一方指定4 s店修理吗?
10万元左右的车划痕险多少钱	多少钱,100000元的车刮伤的风险
哪里有车险新政策的细则	哪里有新的汽车保险政策的细节吗
得病之后还可以买商业保险吗	病后还可以买商业保险
把别人车子撞了，第三方责任险赔车子损失的钱吗？	别人的车撞了,第三方责任保险赔偿损失的钱吗?
哪个保险公司的养老保险好	保险公司的养老保险
太平洋保险公司车辆理赔没有对方的交强险保单的复印件就不给理赔？？？	太平洋保险公司车辆索赔没有其他的副本保险单不是要求? ? ? ? ? ? ?
购买商业健康保险给予个人所得税优惠什么意思	商业医疗保险个人所得税削减你什么意思
交通事故中自己付全责并致自己车上人员伤亡,车险怎么赔	对自己付全部责任和汽车交通事故伤亡,汽车保险如何补偿
谁知道具体的保险公司的业务流程？	谁知道具体保险公司的业务流程?
请问什么是工程保险？工程保险招标的内容有些什么？	请问工程保险是什么?
保险可以重复购买吗？	保险可以重复购买吗?
交强险到期，商业险未到期肇事	保险到期,到期商业保险事故
汽车租赁公司车辆办理保险等其他手续和私家车的一样吗?	汽车租赁公司汽车保险和其他手续私家车吗?
买了保险的汽车撞了之后，多长时间之内修理？	买保险被车撞后,修复时间多少?
请问交通故事人伤理赔是应该去保险公司还是交警大队谈赔偿？如果去交警大队谈好了，保险公司不认怎么办？	是受伤的交通故事声称应该去保险公司或交警大队谈谈赔偿吗?
职业保险与执业责任保险	专业实习责任保险和保险
保险公司的运作模式	保险公司的运作模式
买车险有必要买全保吗	汽车保险购买一切险是必要的
保险公司会预付吗？？	保险公司会提前?
东南v3菱悦改成三菱标违法吗出了事故怎么算?保险公司会理赔吗？交警会因为换标儿额外处罚吗？	东南v3凌越三菱违法事故如何计算?
强制车险和商业险外地车可以在本地买吗?	强制保险和商业保险的外国汽车可以买到在当地吗?
我在人保买的车险（非4s店），可以直接去4s店定损维修吗？可以直赔吗？	我买汽车保险的危险(不是4 s店),你可以直接去4 s店维修费用吗?
汽车保险索赔后第二年的费率	年后的汽车保险索赔
保险中投保人和被保人有什么区别,到期后钱谁领	之间的区别是什么保险投保人和被保险人,领导到期钱吗
在保险实务中,间接损失包括哪些?	在保险实践中,间接损失包括什么?
旧车车险怎么计算？我以前没接触过这方面	旧汽车保险怎么样?
什么是车险的二次查勘？与复勘有什么区别？	汽车保险的二次调查是什么?
异地生小孩报销需要什么手续	不同的育儿费用需要什么手续
2016年生育报销报销需要什么资料	2016家庭费用报销需要什么信息
快速理赔显示已结案钱还没到账	快速调整展示柜钱还没到账户
汽车被人追尾，对方全责。但对方拒绝理赔，对方保险公司说要上诉，请问大家程序怎么走？	次追尾,全部责任。
两车碰撞未报警，车辆可以直接去理赔中心理赔吗	两车碰撞报警、车辆可以直接索赔中心索赔
索赔和理赔的具体区别	索赔和索赔的具体差异
全责撞伤人保险公司怎么赔偿？	全部责任保险公司如何弥补受伤的人?
车被划了，怎么去索赔划痕险	车被划伤了,如何索赔风险
车险理赔记录怎么查询?	汽车保险理赔记录怎么查询?
交强险过期了，商业险没到期。	保险到期,商业风险不到期。
电销车险和直销理赔有什么区别	之间的区别是什么电销车险和直接营销索赔
快速理赔超过2000是怎么处理的	如何应对迅速的索赔超过2000
机票上的延误险申请理赔需要哪些手续	航班延误保险索赔程序所需要的东西
保险公司理赔必须责任双方本人到场吗？	要求保险公司必须责任双方到场吗?
试用期住房公积金单位一定要交吗	住房公积金单位的试用期必须支付
什么是团险理赔	保险索赔是什么
平安保险《家庭综合保险》与《一年期综合意外保险》有什么区别	平安保险(Ping an insurance)“家庭综合保险”,什么是一年期综合意外险的区别
浅谈如何提升车险经营管理能力	讨论如何促进汽车保险经营管理能力
车辆损失险与全车盗抢险有什么区别	之间的区别是什么车辆损失险和全车盗抢险
农村低保，什么条件可以享受低保	农村居民,什么条件可以享受低
退休人员领取退休金每年要办什么手续?	退休人员养老金每年要办什么手续吗?
车碰到别人车怎么理赔	车遇到别人如何说
交强险和商业险分开买有问题吗？？	有问题的保险和商业保险分开买吗? ?
商业保险中高残和全残区别	商业保险高残,残差
想退车险的商业险，是不是必须原车主本人来？为什么？	必须要返回汽车保险业务风险,原来的主人?
被狗咬伤了，为什么意外险不赔？	被狗咬过,为什么不伤亡损失呢?
平安养老保险公司的险种都有哪些？	有哪些类别的保险,平安人寿保险公司吗?
给自己买了意外险工作时手指断了,保险公司会赔么!赔多少	给自己买一个伤亡骨折的手指在工作,保险公司会赔偿!
保险理赔同等责任怎么理赔,要什么资料？	保险索赔如何平等的责任索赔,什么信息?
2016年城镇买新办医保要哪些手续	镇2016年购买一个新的医保手续
车险指定驾驶人和不指定驾驶人的区别	汽车保险不指定驱动程序指定的司机和区别
人寿保险的理赔时效是多久？意外险和健康险的时效多久？一样是五年吗？	人寿保险的限制是多久?
五险两金和五险一金有什么区别	五险两金,之间的区别是什么五个社会保险和住房公积金
意外险有赔偿自杀的吗	伤亡保险金自杀
请问车险理赔时，全责一方和无责任一方收到待遇的区别	汽车保险索赔,请全部责任一方和不负责的政党接受治疗的区别
外省就医医保如何报销	省级医疗保险报销
保险公司核保是做什么的	保险公司承保
买意外险生病住院算是意外吗？到底可以保多少	买保险生病在医院吗?
车子蹭墙了怎么理赔	车蹭墙如何索赔
领取失业金期间可以享受生育保险吗	获得失业救济金期间可以享受生育保险
提取企业年金一定要退休证才能取吗	企业年金的提取必须名誉卡
摩托车保险一定要买驾驶员意外险吗	摩托车保险飞行员必须购买保险
团体意外险是保上下班途中,雇主责任险是保24小时吗	集团伤亡被证实在上班的路上,雇主责任保险是24小时内确认
我的车被他人车所撞，责任全在对方，如何理赔？	我的车被其他车辆,责任在对方,如何索赔?
购买团体意外险的好处具体有哪些？	团购伤亡的特定优势是什么?
平安一年期综合意外险怎么样？	平安一年期综合保险?
我今年48岁，从未交过养老保险。现在不知道该怎么办理	我今年48岁,从来没有缴纳养老保险。
家用车只买交强险和车船税可以吗?	家庭汽车,汽车只能买保险?
新农合在本省和外省报销有分别吗?	新农民省和省报销有分别吗?
学生保险是那个保险公司保的	保险是保险公司保的学生
幸福人寿的聚福宝两全保险（分红）可以投吗？	幸福生活在一起幸福的宝藏养老保险(分红)可以投票?
人寿重大疾病终身保险98版包括什么内容	人寿终身重大疾病保险98年版包括什么内容
二次报销需要什么手续和流程	第二个程序报销和过程
有谁买了国寿新鸿泰两全保险。收益怎样？	谁买了生活的新鸿泰养老保险。
我把别人的车撞了是不是报保险公司	我有别人的车撞了提交给保险公司
2008国寿鸿运少儿两全保险(分红型}分红多少	养老保险是好的小2008个国家(分红}多少红利
车险理赔中要扣残值,如何确定?残值率国家或保险行业是否有规定?	汽车保险索赔扣残值,如何决定?
撞了人并且受伤了，买的是全险，第三者50万，该怎么处理	人受伤,500000年购买一切险和第三方,如何处理
领失业金期间自己交了社保还能领失业金吗	初请失业金人数自己在社会保障仍然可以申请失业救济人数
小孩需要买防癌险吗?	孩子需要买一个得癌症的风险吗?
车辆异地年检，必须要购买当地的车船税吗？	车辆年检,必须想买本地的车吗?
意外险能赔偿食物中毒吗？	食物中毒伤亡可以弥补吗?
车险在4S店上好还是在保险公司上好？区别在哪？	汽车4 s店的保险或保险公司?
车险赔偿金额定损金额	保险的补偿费用
2016年生育保险报销条件流程，生育保险报销范围怎么办理	2016年生育保险报销流程条件下,生育保险报销如何处理的范围
单位把个人档案丢了没法交养老保险办退休怎么办	单位已经失去了配置文件不能支付养老保险退休
车辆商业保险费率是怎么定的，一般是多少？	如何商用车辆保险费率是固定的,一般是多少?
个人意外保险哪家好？	人身意外保险,好吗?
新车车险怎么买	如何购买新汽车保险吗
车险一般哪家保险公司比较便宜	通常保险公司汽车保险便宜点吗
意外伤害保险赔80万要投保多少钱	800000是多少——意外伤害保险覆盖
单位报生育险需要什么手续	单位报告出生危险需要什么手续
我的汽车被盗了,保防盗险是6万元,有免责险,保险公司能赔多少	我的车被偷了,安全范围是60000元,有责任保险,保险公司可以赔偿多少
泰康人寿金满仓B款分红型是骗人的么？	泰康人寿全款分红是一个谎言吗?
社保退保，里面的钱能取出来吗？	投降的社保,里面的钱可以吗?
运费险没有赔怎么办	货运保险不赔
买车保险怎么买	如何购买汽车保险吗
没有对方修车发票车险不给理赔	没有其他发票修理汽车保险索赔
购买商业医疗保险的年龄	商业医疗保险的年龄
保险豁免条款是什么意思？保险豁免条款有什么用？	保险免责条款的意义是什么。
单位车辆办理交强险和商业险需要什么证件	单位车辆处理保险和商业保险需要什么证件
摩托车保险每年都要交吗？要交多少钱？以前没交的要补交吗？	摩托车保险每年应支付吗?
我的社保卡丢了补办了一张这个月的工资能打上吗?	我失去了我的社保卡可以补办本月工资?
生育津贴必须分四次领吗	生育津贴必须带四倍
平安万能险怎样扣费?	平安万能保险费用?
车祸理赔问题。社保和车险可以一起报销吗？	交通事故索赔。
强制险多少钱一年	强制保险一年多少钱
第三者责任险一般投保多少	第三方责任保险通常覆盖多少
请问第一年没报过保险，第二年打几折？报一次呢？两次呢？三次？	请永远不要报保险第一年、第二年一些折扣吗?
如有保险资格证是不是可以为自己买车险？	如果你有任何保险为你的汽车保险证书?
自己撞人后垫付了三万元的医药费,交强险能全赔吗	后支付三万元的医疗费用,保险可以完全补偿
新车保险怎么买划算	如何购买昂贵的新汽车保险吗
阳光保险万能险有些什么好处吗	阳光保险普遍一些什么好
重大疾病保险有必要买吗？	重大疾病保险有必要买吗?
买保险要交十五年,到时候钱能取出来吗	买保险支付15年,到时候可以钱
工伤用医保卡付钱后还可以报销吗	工伤和医疗保险卡支付后可以报销
购买招商信诺教育险有哪些优势？	购买风险投资信诺教育的优点是什么?
65岁以上老人险在哪买？65岁以上的老人还可以投保老人险吗？	超过65岁的风险在哪里买?
交社保是不是以后在户口所在地领退休工资啊	他们的退休金支付社保后的户口所在地
金佑人生保险弊端在哪	缺点金你人寿保险
为什么需要保单年检	为什么需要年检保险吗
58岁还可以交社保吗,怎么交	58还可以支付社会保障,如何支付
太平盛世赢家终身年金保险怎么样	新世纪的获胜者终身年金保险
意外险，是选择长期意外保障，还是选择一年期的意外险，对个人比较合适？	事故伤亡,是选择保护很长一段时间,或者选择一年的伤亡,适用于个人吗?
外地交社保要本人去注销吗	其他地方要社保注销
车险电话车险跟直接到柜台办理有什么区别？	汽车保险电话车险,直接到柜台之间的区别是什么?
车险到期了，但是这几天没时间去上保险请问最晚可以什么时候再买保险车还能上路吗？	汽车保险到期,但这些天没有时间到保险可能最迟什么时候可以购买保险的车又在路上吗?
人保百万身价保险怎么样？	帮助价值数百万的保险吗?
犹豫期内如何退保?犹豫期退保要注意什么?	如何删除犹豫期吗?
失业金领取对于养老保险金有影响吗？	失业救济金为有影响力的养老保险金吗?
泰康人寿A款年金保险可靠吗？两年能取出来本金吗？	泰康人寿的一种养老保险和可靠吗?
飞机票上的航空意外险是否有必要买?	机票的航空事故是有必要买吗?
事业单位退休人，死亡后抚恤金咋计算？	退休人员养老金咋死后计算?
太平洋金佑人生2014的具体条款是什么？	太平洋的条款2014斤你生活吗?
同时保险两家保险公司的人身意外险一旦有意外会得到两家公司的赔偿吗	同时两家保险公司保险人身保险事故将由这两家公司的补偿
车辆过户商业险不过户还能用吗	但是家庭也可以用于车辆转让业务策略
报废车辆退保险要什么手续吗?	什么手续报废车辆投降吗?
社会保障卡没有激活旧的医保卡还能用吗	社保卡是不活跃的旧卡还可以用于医疗保健
车子撞树上了单方事故车辆维修吗费用交强险赔吗	汽车撞到树它单方面事故车辆维护费用保险补偿
车辆没有到报废期能否办理报废补贴	没有车辆BaoFeiQi可以处理报废补贴
给自己上保险会不会影响低保的发放？	给自己上保险会影响低的分布?
向保险公司提出先垫付交通事故医疗费需要哪些手续	向保险公司提出支付第一次交通事故医疗需要什么手续
农合异地就医如何报销要多长时间	长途的农民需要多长时间去一个医生如何报销
太平附加福佑金生重大疾病保险怎么样	太平附加幸福kinson重大疾病保险
招行信诺重疾险好不好？	招商银行信诺重疾病风险吗?
新华保险近期关于儿童的险种有哪些	新华保险最近孩子什么样的风险
买车购置税在哪里交？购置税需要缴多少	汽车税收由于在哪里?
强制险一年多少钱	强制保险一年多少钱
中国人寿的“福禄金尊”两全保险和平安“金裕”哪个好？	中国人寿养老保险“命运的黄金雕像“和平“金”,好吗?
平安保险成年人买什么分红保险合适	平安成人购买保险的分红的权利
交通事故对方全责我方保险公司可先赔偿吗	交通事故的其他全部责任保险公司可以赔偿
重大疾病保险买返还的还是消费型的好	重大疾病保险买回或消费品
幸福人寿会倒闭吗	幸福的生活将会崩溃
保险公司是靠什么来挣钱的？怎么获得的收益	保险公司是赚钱的?
人保车险续保大概花多少钱的	保护汽车保险更新可能花多少钱
保险渗透率的定义是什么？什么是商业车险渗透率？如何计算？	保险普及率的定义是什么?
中*人寿保险犹豫期退保没有回执怎么办?	阶段犹豫*人寿保险投降没有收据吗?
太平福佑金生终身寿险和平安智慧星哪个更好	太平天国幸福kinson一生和平ji-hye安明星哪个更好
异地可缴纳农村医疗保险吗?	长途可以使农村医疗保险吗?
报了保险了还能取消吗	保险可以取消
低保人员可以交保险吗	低保护人员可以支付保险
国寿鑫易宝和鑫如意哪个产品更好	ShouXin易建联Baohe鑫运气哪个产品更好
重大疾病保险多家可以同时赔付吗	几个重大疾病保险可以支付在同一时间
公司给我交五险，基数是2300，一个月我个人应该交多少？	公司给我交五险,基本是2300,我个人应该付多少钱一个月?
泰康财富人生e款年金保险分红型返还本金吗	泰康人寿财富e型模式的养老保险的分红还本金
儿子今年2周岁了想在中*人寿鑫如意是5年的好还是10年的好	儿子今年两周岁鑫灵活*生活5年或10年的好
养老金在多个城市缴纳满15年能领取吗	养老金在几个城市可以缴纳满15年收集
在编教师辞职后养老与医疗保险怎么办	写作老师辞职的养老金和医疗保险
补充医疗保险可以个人名义上么？	个人补充医疗保险可以吗?
安邦保险退保后几天到账？	商业保险投降几天后账户?
手机碎屏险一般保期是多久的？	手机屏幕破碎的风险一般m是多久?
新华保险没过犹豫期退保要什么手续	新华保险问题毫不犹豫地放弃什么程序
国寿鸿盈两全保险分红型是什么保险,交的是1万,6年，是什么意思呢?它的分红时间是好久呢?	是什么ShouHong分红保险养老保险,工资是10000,六年,这意味着什么呢?
银行里买的保险到期后能返还本金吗	银行可以购买保险到期后归还本金
社保跨省转移影响养老金的领取吗?	省社会保障转变得到养老金吗?
车子全保保险公司能赔偿全部费用吗？	汽车所有风险保险公司可以赔偿所有费用吗?
买保险必须要银行卡缴费吗?现金不行吗?	买保险必须支付银行卡的费用吗?
农保卡跨省可以报销吗	农业保险卡省可以报销
生孩子住院报销新农合需要哪些手续	生孩子在医院里为新农业需要什么手续
互联网保险对传统保险销售带来哪些影响	互联网保险影响传统保险销售
航班延误最后导致航班取消航班延误险可以不赔付吗	最后导致航班取消的航班和航班延误风险不能支付
丈夫有交社保.妻子可以享受生育保险吗	丈夫支付社会保障。
企业不给员工缴纳保险给补助可以吗	公司不支付保险补贴可以给员工
保险过了犹豫期想退保怎么办	保险在犹豫时间想投降
外地牌照能在本地上保险吗	可以在本地外地牌照保险吗
公司帮员工办失业保险需要开什么证明吗	公司帮助员工去做需要开放的失业保险证书
生育保险女方报销男方可以报销吗	生育保险的女人男人可以报销
邮局存钱被忽悠买保险还在犹豫期能退保么	邮局储蓄金钱诱惑可以买保险期间毫不犹豫地投降
交通事故造成受伤,出院后在家静养,保险公司如何补偿	交通事故造成的伤害,出院后在家休息,保险公司如何赔偿
出事故付主要责任,事故施救费保险公司可以报销吗	付主要责任事故,保险公司报销事故救援
车辆保险的交强险与商业险可以分开交吗	车辆保险的保险和商业保险可以单独支付
电话车险怎么样	汽车保险电话怎么样
孩子没有上户口。可以买保险吗？	在不考虑。
对方全责保险已赔付对方不给钱怎么办	对方全部责任保险支付对方不给钱
外地人在当地能不能办理新农合医保	外地人在当地农民可以处理新卫生保健
中*人寿保险汽车保险过户需要什么手续，在那个营业厅都能办吗	*人寿保险汽车保险转移需要什么手续,在营业厅
国寿福馨两全保险的收益是怎样的	ShouFuXin养老保险的好处是什么
住院医保保险，怎么报，需要些什么材料？	住院医疗保险,如何报价,需要什么材料?
不同省份可以同时缴纳五险一金吗	不同省份可以支付五种社会保险和住房公积金在同一时间
14座客车交强险和车船税多少钱	14乘用车保险和汽车多少钱
交通事故超载百分之五十保险公司给理赔吗	交通事故超载百分之五十的保险公司索赔
我要退保需要什么手续	我不得不放弃需要什么手续
车险需要交多少税，都是什么税	真正需要支付税,税吗
商业补充医疗保险有什么好处	商业补充医疗保险的优点是什么
机动车第三者责任险可以承担自己的车辆维修费用吗	机动车第三者责任保险可以自己负责车辆维修成本
买中*人寿*福年年保险在犹豫期内退保要什么程序?	购买* * f生活保险每年在犹豫期内投降程序是什么?
平安福犹豫期退保要收到回访电话才可以吗？	和平f犹豫期投降召回吗?
7万元的车；车损险是多少么？盗抢险是多少？	70000 yuan car;
交通事故有人受伤是自己出面还是保险公司出面	交通事故伤害本身或保险公司
车辆被追尾，保险已定损金额，但是我认为保险定损过低，如何处理？	次追尾,保险费用金额,但我认为保险费用太低,如何处理?
车辆脱审脱保申请报废,需要什么手续，到哪里去办理？	TuoBao申请报废的车辆,需要什么手续,你要去处理?
保险理赔不满意怎么办	保险索赔不满意
由于违规驾驶出现事故保险公司是否赔偿	是否由于非法驾驶事故保险公司赔偿
保险合同的基本条款的主要内容有哪些	什么是保险合同的基本条款的主要内容
车子在外地出了事故可以回当地维修吗，会不会影响理赔	汽车出了事故现场可以回到本地修复,不会影响索赔
投保单位是指什么？被投保单位是指什么？'	保险应用程序是指?
请问阳光车险的道路救援管用吗？	你能告诉我阳光车险道路救援工作?
中*人寿少儿险种哪种最划算	*人生孩子种植什么样的最具成本效益的
网上车险好还是电话车险好	网上或电话汽车保险汽车保险好
驾龄不满1年上高速出事故保险赔吗	驾驶体验不到一年意外保险成本
车险业务员打电话来的，靠谱不？还是直接打电话投保便宜些？	汽车保险推销员,光谱?
交通事故完全是由保险公司赔偿吗?司机全责该另外赔偿什么项目吗?	交通事故是完全由保险公司赔偿吗?
打电话来卖保险的和自己到保险公司买有什么不同吗	打电话来卖保险和到保险公司购买的区别是什么
车险理赔中要扣残值,如何确定?残值率国家或保险行业是否有规定?	汽车保险索赔扣残值,如何决定?
保单遗失了怎么办？	政策是失去了吗?
外地车在异地交保险影响年检吗	非局部效应在不同地面支付汽车保险年度检验
给孩子买了学平险之后还有必要买其他的保险吗？	后买了孩子学习平风险和其他需要买保险吗?
20元航空意外保险能赔延误.是真的吗	航空意外保险可以补偿延迟20元。
小孩子有必要买意外保险吗？	一个孩子必须购买意外保险?
车损险有必要保吗	覆盖保护是必要的
全车盗抢损失险第二年需要买吗	第二年需要买整车DaoQiang丧失的危险
异地买车险可以吗？要注意什么？	长途汽车保险吗?
阳光电话车险怎么样？	阳光电话汽车保险吗?
平安车险有免费救援吗	平安保险(Ping an insurance)无偿援助
车祸致人死亡保险公司赔偿需提供哪些材料	车祸杀死是什么材料需要提供保险
汽车基本五险包括哪些险种？	基本的五个风险包括那些风险?
我想知道中*人保财险车险的保险卡上，各个险种的字母代码分别是什么意思？回答全面点哦！	我想知道*保险公司汽车保险在保险,险种字母代码分别是什么意思?
肇事逃逸保险公司是否赔偿交强险	发生了一起车祸,保险公司是否赔偿保险
准备买平安的车险，行驶证是我爸的名字，我可以作为投保人和被保险人么？因为车是我在开。谢谢！！	准备买汽车保险,登记的名字是我的父亲,我可以是投保人和被保险人吗?
平安车险是先定损在修车吗?定损要多久	平安汽车保险费用在车库里?
泰康人寿鑫享人生是个什么样的险种	泰康人寿鑫享受生活是一个什么样的风险
儿童的意外伤害保险赔偿标准是什么？	儿童意外伤害保险补偿标准是什么?
自己改装对汽车加装了侧踏板,出事故了保险公司赔偿吗	他们修改的汽车配备侧踏板,意外保险
交强险出险一次，会影响商业险吗？	保险金的时候,影响业务风险?
新车缴纳交强险，给的车贴标识没有打印车牌号，有法律效力吗？	新车保险待遇,给贴纸标识没有打印车牌号,有法律效力吗?
高空坠物损坏车辆平安车险是否可以全部赔付？	坠落物体损坏车辆安全的汽车保险都可以付款?
附加给付型重大疾病保险什么是附加给付型重大疾病保险	额外的附加到复兴复兴什么重大疾病保险重大疾病保险
座位险赔偿范围	座位风险补偿范围
误机险怎么赔偿是现金还是?	光线补偿小姐是现金或保险吗?
平安福保单贷款需要什么条件？	祝福和平政策贷款需要什么条件吗?
怎么查询保险到期时间，保险到期时间怎么查？	如何查询保险到期时间,你如何检查保险到期时间吗?
平安学校保险报销比例是多少？	保险和平学校报销比例是多少?
中*平安和中*联合哪个车险好啊？	的* *在和平与联合汽车保险是好的吗?
年金保险存在的意义是什么？什么样的人群会去购买年金保险？	养老保险存在的意义是什么?
如果自杀(已买了保险两周年),保险公司有赔偿吗?	如果自杀(两周年)购买了保险,保险公司赔偿吗?
保险公司会倒闭吗?如果发生了,收益人怎么办?	保险公司将会崩溃吗?
重疾险赔付三次和赔付一次的区别	重大疾病保险索赔和支付三倍的区别
不买车辆损失险不记免赔能买吗	不买汽车损失险免赔额
电话车险和柜台车险有什么区别为什么电话车险比柜台车险便宜	之间的区别是什么电话汽车保险和汽车保险计数器为什么电话车险比柜台便宜的汽车保险吗
信用卡黑户可以买保险吗	信用卡的黑色会购买保险
车辆可异地报废吗	车辆可以超出了废品
车险保险公司排行怎么看？平安车险实力怎样？	汽车保险保险公司名单?
刚买的车险发票不见了，车要年审怎么办	刚买了汽车保险发票丢失,车要小心
车险电话销售和传统销售价格一样吗	汽车保险电话销售与传统销售的价格是一样的
关于人保电话车险，不同地区购买价格相同吗？	危险的电话车险,不同部分的购买价格是一样的吗?
已购买的保险还没生效能退款吗	还没有买保险可以影响退款
平安网上车险和实体店购买车险有区别吗	平安网上车险和实体店购买汽车保险有区别
按照损失补偿原则，保险人行使代位求偿的前提条件有哪些	按照赔偿的原则,被保险人代位求偿权行使的前提条件
中*人寿车辆保险出险后处理流程，如何的？包括中*人寿车险到底如何？	*生活车辆保险赔偿的后处理过程,如何?
自己车辆发生事故维修报保险一般是怎么付钱	他的车祸保险通常是如何支付维修报价
车险过户可以更改投保人的吗?更改的新投保人跟新车主不是同一个人可以吗？有什么规定？	汽车保险投保人的转移可以改变?
阳光车险可以直接通过电话支付吗？	阳光汽车保险可以直接通过电话吗?
请问保险代位赔偿是全额赔偿吗？	保险代位赔偿全额补偿,好吗?
阳光车险为什么没有代收车船税	为什么没有太阳车险收集车辆
平安电话车险保单出了,生效时间没到,钱没付可以取消不	和平电话的汽车保险政策,有效时间,金钱可以取消没有支付
加装倒车影像，和法吗？出交通事故保险公司会给第三赔偿吗？	配备反向图像,和方法?
车险理赔一直没下来可以投诉保监会吗	汽车保险索赔可以投诉中国保监会还没有下来
交强险出险后全责会不会影响以后的保险赔率	保险责任后将影响未来或摆脱危险的保险
新华保险的金彩一生保险属于什么类型的？传统？分红？万能？	新华社保险金属于什么类型的人寿保险吗?
平安车险网上续保的话，保险单子是当地出吗？可以自己去取吗？	平安保险(Ping an insurance)在线更新,是一个当地的保险清单吗?
事故交强险赔偿标准第一次报了保险，来年保险费会有增额吗	保险,意外保险赔偿标准首先引用了在未来一年将附加保险费
投人保电话车险能送单吗？	在危险的电话车险可以发送列表吗?
我车出险报案了然后我又注销了还能恢复吗	我的车事故报告,然后我可以写回
过了48小时报案保险公司会理赔吗交警大队已经下了认定书	后48小时内报告任何保险公司会要求交警大队有区别
车辆年检要先买保险吗	年检的车辆购买保险
第一次报了交强险后来年保险额会增加吗	首次报道了保险金额将增加
小孩礼*天在家摔伤骨折在幼儿园买了学平险可以报销吗	孩子在幼儿园*天受伤骨折在家买了学习平风险可以报销
我撞坏了别人车,我上了车险,别人也上了车险，保险公司应该怎么赔	我的车,我的车保险,其他汽车保险,保险公司应该如何补偿
一年报两次车险第二年车险有什么影响	在第二年年度报告两次汽车保险汽车保险有什么效果
保险中的残值是什么意思	残值保险是什么意思
航空组合险和航空意外险有什么区别？	之间的区别是什么航空投资组合风险和航空保险吗?
强制保险贴丢了，怎么补办	强制保险,如何填补
汽车保险能否异地理赔?	汽车保险是否不同的索赔吗?
保单超过半年可以贷款吗	政策可以贷款超过半年
车子没用可以不交强制险吗	车不工作不能强制保险
新华保险的保单贷款是怎样还的?	新华保险政策贷款也如何?
保险的投保人和被保险人必须是直系亲属关系吗？（姐弟兄妹可以吗）	保险的投保人和被保险人必须是直系亲属关系?
在工地上干活的工人要上什么样的保险	在网站上工作的工人想去什么样的保险
第三者保险营运与非营运什么区别	有什么区别的第三方保险业务操作
汽车商业保险能立即生效吗？	汽车商业保险可以立即生效吗?
保险退保怎么算	保险投降是多少
车辆上牌照必须在当地上保险吗	汽车的牌照必须在当地保险
企业保险和事业保险有什么区别	企业保险和保险的区别是什么
保险保全的办理保全的注意事项	保险保护安全方面的考虑
香*保险有哪些种类？	什么类型香*保险吗?
三者险是不是无责任不赔啊	一切险是不赔偿的责任
交强险没生效可以退吗	保险可以退款不生效
在投资连接保险中,基本保险责任包括什么	投资连接保险,基本保险责任包括
购买的车险可以退保吗？	可以买到汽车保险投降吗?
什么情况下保险公司可以垫付赔偿金	什么保险公司赔偿可以支付
交强险有报案时间限制吗	保险报道时间限制
交强险未起保能退保吗	保险是不能保证投降
车辆过户保险是按新车算吗?	汽车保险是转移计算通过一辆新车?
有社保和没社保买商业保险的区别	社会保障和社会保险购买商业保险
办建筑工人意外险需要交什么证件	伤亡为建筑工人需要支付证书
买车投保基本五险三者50万是什么意思哪五险？	500000是什么意思基本五车三个五个保险风险?
车辆商业险包括哪些	商业风险包括车辆
支付宝上购买重疾险怎么报销	支付宝购买重疾病保险报销
简单赔付率是什么意思？	简单赔付率是什么意思?
意外险和医疗保险有什么区别	保险和医疗保险的区别是什么
保险公司如何计算获赔率如何计算	如何计算赔率如何计算保险公司
第三者责任险和不计免赔险和车损险都有什么区别？	第三方责任保险,不包括特许经营风险和保险的区别是什么?
安全生产责任保险实施范围包括哪些行业	安全生产责任保险实施的范围包括哪些行业
买了一份商业保险没拿到合同怎么退保但是钱已经扣了怎么退	买了商业保险不拿回合同如何投降但钱已经扣了
保险合同主体变更包括哪些方面	保险合同是改变话题包括哪些方面
车辆损失与人伤能否同时由保险公司代位赔偿？	车辆损失和人可以伤害和代位由保险公司赔偿吗?
商业医疗保险的种类有哪些该如何选择	是什么类型的商业医疗保险如何选择
交强制保险的时候还要交车船税吗	当支付强制保险支付车
车险新政策2016代位赔偿属于出险吗	新车保险2016代位赔偿属于或摆脱危险
如何在美*购买医疗保险	*在美国购买健康保险
平安犹豫期退保后要多久可以再买?	要多长时间才能和平犹豫期投降后可以再买?
挡风玻璃在高速公路被石子砸裂，有车损险可以报保险吗？	挡风玻璃在高速公路上被压碎石头,覆盖可以报保险?
昆*车船税在哪里交	他*的车在哪里
生育保险和生育基金有什么区别	之间的区别是什么生育保险和生育基金
残疾证与商业保险有关系吗?	残疾和商业保险重要吗?
如何获得保险业务经营资格	保险业务经营资格怎么走吗
国寿瑞鑫典藏版怎样算保费	如何计算保险费的收集ShouRuiXin版本
职工社会保险和居民社会保险有什么区别	什么是职工社会保险和社会保险的区别
司乘险与乘座险有区别吗？	公司承担风险,承担风险的区别吗?
太平洋安行宝两全分红保险怎么样？	太平洋宝分红的养老保险吗?
贷款买养老保险如何办理？	如何处理贷款买养老保险吗?
社保局生育保险报销需要哪些材料？	社会保障局生育保险报销需要什么材料吗?
建筑工人意外伤害保险是强制保险吗	建筑工人意外伤害保险是强制保险
个体户如何申请生育保险	Soho如何申请生育保险
出了车祸发现没有购买车船税保险公司会理赔吗	出了车祸发现没有买汽车保险公司索赔
国际货物运输保险包括哪些内容	国际货物运输保险包括哪些内容
农村合作医疗保险异地可以报销吗？	可以远距离的农村合作医疗保险报销吗?
国寿瑞鑫两全保险分红型和国寿附加瑞鑫提前给付重大疾病保险，是怎么保的？	养老保险的分红ShouRuiXin类型HeGuoShou额外瑞鑫提前支付重大疾病保险,如何保护?
生育险报销有时间限制吗	有时间限制生育保险报销吗
失业保险可以一次性领取吗	可以一次性获得失业保险
报销意外险必须要原件发票吗？	报销保险必须是原始发票吗?
有农村医疗保险还需要买疾病保险吗？	农村医疗保险还需要买一种疾病吗?
办理生育险去哪办理?	办理生育险处理?
商业保险都可以报销什么医疗保险	商业保险可以报销医疗保险
深*重大疾病补充医疗保险包括哪些重大疾病	什么深*补充医疗保险主要疾病包括重大疾病
办车险退保险一定要本人吗	保险汽车保险我必须申请退款
生育险哪些费用可以报销	生育保险费用可以报销
在异地能交车船税吗？	在这段漫长的距离到达的车吗?
医疗保险和综合医疗保险有区别么	医疗保险和综合医疗保险有区别
保险里的豁免是什么意思	你什么意思豁免的保险吗
汽车保险到期了可以换其他保险吗	汽车保险到期可以改变其他保险
房屋抵押要交保险费吗	抵押贷款支付保险费
保险费率厘定的公平原则的含义是指什么？	股本保险费率的设置原则的含义是指什么?
保险可以异地购买吗	在另一个地方可以购买保险
保单贷款被保险人可以么	政策贷款被保险人可以
保险可以过户吗？	保险可以转移吗?
广州生育保险的报销流程	广州生育保险报销流程
生育险报销时间一般是多久？	生育保险报销时间一般多长时间?
车辆保险赔偿需要车主身份证吗，需要车主本人签字吗	车辆保险赔偿业主id,需要老板签字
保险1类到6类的区别是什么	之间的区别是什么保险1 - 6类
中*人寿保险意外险受理后多长时间能报销	*要多长时间才能人寿保险事故后接受报销
第三者责任险需要买吗第三者责任险可以不买吗	第三方责任保险需要购买第三方责任保险可以不买它
保单贷款怎么办理	政策贷款如何处理
保险退保如何计算	之前如何计算
对方没有保险可以代为追偿吗?	彼此没有保险你能恢复吗?
保险失效后再复效不会影响理赔吗	保险到期回答效应不会影响索赔了
车辆出险以后的保险费怎么计算	车辆或离开后如何计算保险费的危险
人保车险赔付要几天才能到帐呢	多少天到帐户维护汽车保险索赔
车子异地出事故必须拿回当地保险公司理赔吗！	长途汽车交通事故必须回到当地的保险公司索赔!
汽车保险过期多久算是脱保汽车保险保险过期三天出事了这样的情况能不能找保险公司理赔	汽车保险是姗姗来迟TuoBao汽车保险保险事故三天迟到的情况可以找保险公司索赔
国寿保险退保现金价值怎么算？	人寿保险退保现金价值如何计算?
平安退保怎么办理	平安,如何处理
杭*生育险连续满12个月是什么意思	杭州*生育保险连续12个月是什么意思
购买失地农民基本保险的条件是什么	失地农民购买基本保险的条件是什么
定期寿险和重疾保险与意外保险有什么区别？	定期人寿保险和重大疾病保险和意外保险有什么区别?
社保医疗与商业保险报销有冲突吗	医疗社会保险和商业保险报销有冲突
保险合同指定受益人和法定受益人的区别	保险合同指定受益人,受益人的法律的区别
户口不在本地如何办医疗保险	户口不是本地医疗保险怎么做
互联网保险需要牌照么？	互联网保险需要执照吗?
车险保险合同生效后可以退吗	汽车保险保险合同生效后可以退还
变更社保地如何办理	如何处理社会保障计划的改革
2016年重*生育津贴是怎么算的	2016 *生育津贴是如何计算的
新农村合作医疗包括养老保险吗	新农村合作医疗包括养老保险
商业险三者险不计免赔是什么意思	商业风险三个风险无论特许经营是什么意思
生育险检查费可以报销吗	生育保险检查费用可以报销
我是外地户口想交养老保险怎么办	我想让外地户口养老保险
昆*车船税在哪里交	他*的车在哪里
新农合办理特种病的流程	新农民应对特殊疾病的过程
交通意外事故医疗保险可以报销吗	交通事故医疗保险可以报销
车辆保险必须在每年的同一时间买吗?	车辆保险必须在今年同时购买吗?
大车保险包括哪些	车保险
退农保要什么手续	是什么程序还农民
如何区分保险是月交还是年交的？有什么分别	如何区分保险一个月在支付吗?
青*最新生育保险报销需要什么材料	绿色*新生育保险报销需要什么材料
办养老保险缴费凭证需要哪些资料	哪些数据需要做养老保险费证书
请问：保险理赔是什么工作？具体的职责都是什么？	请问:什么是保险索赔?
农村养老保险和单位的养老保险能同时交吗？	农村养老保险和养老保险单位同时可以交?
成*生育报销需要几个月	*出生报销需要几个月
购买汽车保险的发票丢失现在想退保怎么办理	买汽车保险发票丢失想放弃现在如何处理
车险里哪些是必须买的强制买的保险？	在汽车保险是必须强制购买保险吗?
个人所缴居民社保可以转为农村养老保险吗	个人缴纳社保可以转化为农村居民养老保险
交强险出险一次商业险第二年还有优惠吗	保险或摆脱危险的第二年的商业风险和激励
有社保卡医疗费怎么报销	如何有一个社会保障卡医疗报销吗
生育保险具体怎么使用	生育保险具体如何使用
现在二胎可以报销生育险吗	两个胎儿现在报销生育险
男方领取生育假津贴需要哪些资料	出生的人得到休假需要什么数据
买外地二手车保险怎么过户	购买一辆二手车保险如何转移出城
二胎可以领取生育津贴吗	两个孩子可以生育津贴
二手车保险不过户可以吗	汽车保险但家庭可以使用
年金保险和养老保险有何区别	之间的区别是什么养老保险和养老保险
二手车过户时保险怎么处理	二手车保险转移时如何处理
新农合转院手续怎么办	新农业和推荐
农村户口养老保险怎么交	农村户口的养老保险待遇如何
新车按揭购车必须要上哪些保险	必须在新的抵押贷款购买什么样的保险
保险理赔金算不算夫妻共同财产	要求保险公司赔偿了不是丈夫和妻子的共同财产
辞职了还能领生育金吗	可以放弃的诞生黄金
每年买保险，都要重新缴纳车船税的吗	每年购买保险,支付汽车
个人社保怎么办理暂停	个人社会保险如何处理暂停
牙科在医保报销范围吗？	牙科保险报销范围?
办理房贷一定要买保险吗	处理抵押贷款必须购买保险
机动车可以异地购买保险吗	机动车可以在另一个地方购买保险
可以异地买车辆保险吗	可以买一个长途汽车保险吗
人身意外险包括哪些意外保险种类	人身保险,包括什么类型的意外保险
生育保险报销和生育补贴需要什么手续和流程	生育保险报销生育津贴和需要什么手续的过程
缴纳车辆购置税需要什么手续	缴纳车辆购置税过程所需要的东西
一年车子走两次保险，第二年保险费用会增加吗	汽车保险一年两次,第二年的保险费用将会增加
车船税每年都要买吗？为什么每年都要缴纳车船税？	汽车每年购买?
医保是什么?医保的种类有哪些？	健康是什么?
个人如何办理养老保险	如何处理个人养老保险吗
异地社保医保可以转吗？	异地社会保障覆盖范围可以吗?
医保卡具体用途有哪些？	具体使用医保卡是什么?
新车买保险注意哪些	注意什么新车购买保险
广州医保报销流程	广州报销流程
城镇职工医保如何报销？	城镇职工医疗保险报销吗?
医疗保险查询怎么查？	医疗保险调查如何检查?
小车交强险一年多少钱	汽车保险一年多少钱
生育保险如何领取?	如何将生育保险吗?
养老金和退休金有何区别？	养老金和退休的区别是什么?
汽车保险过户怎么办理	汽车保险转移如何处理
泰康人寿保险的险种哪种是最好的	泰康人寿保险是最好的
大病保险要多少钱？包含在社保中吗?	大病保险多少钱?
中*人寿保险险种介绍的多不多，有什么好的推荐	*你有多少人寿保险种植介绍推荐
泰康乐安康是个什么产品，怎么样？	泰国休闲安康是什么产品?
重大疾病保险什么时候买最好。	重大疾病保险,是最好的时间去买。
中*人保的产品好不好？服务怎么样？	*在危险的产品?
个人医疗保险查询是怎么查的	个人医疗保险查询是如何检查
信泰千万传承产品怎么样？是不是值得投保？	它必须转移产品吗?
平安保险平安福介绍的多吗？这款产品怎么样？	平安保险(Ping an insurance)和平f介绍?
中荷人寿保险怎么样？产品多不多？	在人寿保险吗?
重大疾病保险哪个好？哪家保险公司的好	重大疾病保险,好吗?
平安医疗保险买多少钱的合适？	平安健康保险买多少钱?
新康宁终身保险好不好？有没有投保？	康宁终身保险,好吗?
绿野户外保险能不能买？产品怎么样？	向导户外可以买保险吗?
什么叫大病保险？大病保险有什么用？	大病保险是什么?
美*出境保险一份多少钱？去美*要买多少保费的？	一个漂亮的*退出保险多少钱?
安联境外保险产品怎么样？出国旅游买安联好吗	安联保险产品在国外吗?
美亚保险百川保险好不好？谁来说下！	Aiu保险百川保险吗?
智悦人生万能险缺点有哪些？适合买吗？	缺点ZhiYue万能人寿保险是什么?
中民保险网好不好和慧择相比哪个好点	保险网络是好的和回族的人相比,选择哪个好点
泰康意外险怎么样？产品种类多不多？	泰康人寿保险吗?
美亚保险理赔快速吗？理赔的服务好不好？	Aiu保险索赔快?
平安保险畅行天下怎么样？保障高吗？	平安保险在世界各地吗?
优保网和慧择网哪个好？哪个理赔快？	最优网络和回族选择网络,好吗?
太*洋旅游意外险短期的有没有？在哪能买？	太*海洋旅游意外险短期?
在慧择网买保险靠谱吗？有买的吗？好理赔吗	在回族选择光谱净购买保险吗?
平安户外运动保险适合去哪些地方玩买	平安保险适用于户外运动在哪里购买
美亚潜水保险能买吗？真的用必要吗？	美亚保险购买潜水吗?
美亚乐悠游保险是个什么产品好不好	le导航美亚保险是什么产品
平安户外保险多不多？爬山的话买什么样的	平安户外保险多少钱?
平安智悦人生是什么年龄人用的?一年多少保费?	什么年龄的人使用安全ZhiYue生活吗?
太*洋境外保险一份要多少钱？怎么买好境外保险	太*海外保险要多少钱?
想出去旅游，问一下户外平安保险一份要多少钱？	想出去旅游,问平安是多少,一个户外吗?
拉磨保险和慧择保险哪个便宜理赔快	、保险和快速选择廉价的保险索赔
国寿安鑫两全保险怎么样？能不能买	养老保险ShouAnXin吗?
美亚保险优惠券有用吗？能优惠多少	Aiu保险凭证有用吗?
美亚保险飞机延误险最高能赔偿多少？	Aiu保险飞机延迟风险最高可以补偿多少?
国寿金转换年金保险是个什么保险？怎么领取保险金的？	生活转变养老保险保险是什么?
平安一生无忧年金保险是有返还的吗？能返还多少？	安全生活养老保险是一种回报呢?
国寿通泰交通意外险保障哪些安全？	州ting通泰交通事故,确保安全的什么?
新华保险多倍保好不好？	新华保险多次确认好不好?
平安安康住院费用医疗保险只是赔偿住院费用吗?	平安健康保险成本安康医院医疗费用补偿?
新华荣耀人生两全保险怎么样？能不能买？	新华人寿保险的满意的荣耀?
一起慧99百万医疗保险好不好？买的人多吗？	回族9900万年健康保险在一起,好吗?
国寿福瑞人生两全保险保障是哪些？能给父母买吗？	的养老保险ShouFuRui生活保障是什么?
一起慧99百万医疗保险是哪个公司出的？保额是多少？	回族9900万医疗保险是哪个公司?
国寿金色夕阳养老保险到什么年龄能领取保险金	金色的夕阳的生活养老保险什么年龄可以得到保险
平安乐享福到什么时候可以领取保险金？	平一块去我什么时候能得到保险?
国寿e保通保险是个什么产品?买的人多不多	e鲍彤保险产品的生命是什么呢?
国寿母婴安康保险是怎么买的？适合什么年龄层的？	孕产妇和婴儿的生命是如何买健康保险吗?
请问现在有0免赔的保险产品吗？想要给自己买份保险	现在有0特许经营保险产品?
0免赔额的百万医疗险值不值得买？	0系列数以百万计的卫生保健是值得买吗?
健康医疗保险要怎么买啊保额定为多少好	如何购买健康保险的前额上一样好吗
0免赔额的百万医疗险跟1万元免赔额的百万医疗险相比，究竟好在哪儿？	0系列数百万相比10000美元特权医疗、是否在哪里?
慧择的一起慧99医疗险的100%赔付靠谱么？	明智的选择的回族一起在99年100%的医疗保健索赔吗?
有什么健康险可以报销的费用多些的，意外医疗各种费用都可以报的	医疗保险可以报销费用,事故医疗费用报价吗
最近推出的一起慧99是不是值得办理投保	最近推出了回族99值得应用
最近比较火的0免赔额百万医疗险一起慧99，不承诺续保，如果发生了理赔，就不能买了吧？	最近更多的火0系列回族99在一起,不承诺更新事件的索赔,不能买了?
听说有0免赔的医疗保险，靠谱吗？亲们有没有靠谱的产品推荐下？	在医疗保险,听说0系列频谱?
一起慧99这个保险的保障内容是什么	回族99的保险保障是什么内容
在很多保险中有一万到三万不等的免赔额是什么意思？	从一万年到三万年在许多保险免赔额是什么意思?
有没有保额在一百万的医疗保险？想要投保一份？	一百万年你有医疗保险吗?
最近网上比较火的百万医疗保险一起慧99，有无社保对保费有影响吗？	最近火数以百万计的在线医疗保险回族99多在一起,社会保障是否影响保险费?
网上能买到一起慧99这样的保险吗	网上可以买回99个这样的保险在一起
一万元免赔额的百万医疗险和零免赔额的哪种好？	一万元系列数以百万计的卫生保健和零免赔额,好吗?
看到现在很多的保险免赔额都是一万的，有没有比这更低的？	现在看到的许多保险免赔额是一万,低于这个吗?
一起慧99的叮咚理赔是怎么样的	回族99叮咚声称在一起
慧*安是哪个公司的保险？	安回族*哪个保险公司的?
把产品销售到国外有哪些渠道可以搞	产品在国外销售渠道可以是什么
想要投保惠馨安产品，在哪里买	要确保回心产品和在哪里买
刚上幼儿园的小朋友,买份重疾险,有推荐的吗	只买幼儿园孩子,大病保险,建议
慧*安*儿定期重疾是怎么理赔的	安回族* *的儿子如何定期重复索赔
一起慧99说是可以续保到99周岁，但是又有非保证续保，是什么意思	说可以更新回族99到99岁,但却不能保证更新,是什么意思
最新推出的少儿重疾险慧馨安的亮点是什么？	最新推出的儿童严重疾病风险汇鑫安的窗口是什么?
和谐健康保险慧馨安产品咋样	和谐健康保险汇鑫安你喜欢我们的产品
慧*安*儿定期这个保险有什么特色？	安回族* *的儿子是什么特殊定期对保险的吗?
小孩子重疾保险买多少保额的合适?	孩子们沉重的疾病保险购买多少合适?
少儿平安福和慧*安选择哪个好	孩子的和平与智慧*选择哪个好
儿童重疾怎么多要怎么选	如何选择多少孩子严重的疾病吗
投保慧馨安少儿险如果要理赔怎么走流程	BaoHuiXin安儿童风险如果你想怎么去索赔过程
市场上很多少儿健康险保额都是五十万的，还有比这更高的吗	市场上很多儿童健康保险是五十万,比这要高
小**才两岁多点，重疾险要怎么投保	更* *只有两岁,重病覆盖它
男孩5岁能不能买重疾健康保险？	这个男孩可以买五重疾病医疗保险吗?
三年级孩子买要不要买意外险？	三年级的孩子买想买保险吗?
给孩子买少儿健康险保额定在多少合适	给孩子买一个儿童医疗保险权利
家里有点闲钱，想要给孩子买保险，买什么样的好？	一点额外的钱在家里,想给孩子买保险,买什么好呢?
小孩子重疾保险买多少保额的才合适？	一个孩子沉重的疾病保险购买多少?
宝宝两岁，学校给买了学平险，还要买意外险吗？	购买婴儿两岁,学校平,还想买保险吗?
我家女儿刚刚上幼儿园，想给她买一款保障健康成长的保险，买什么好？	幼儿园,我的女儿想给她买一个保证保险的健康发展,买什么好呢?
宝宝才一岁半，每天看着她一点点长大都很开心，有没有比较好的保险推荐？	婴儿只有一个半,看着她一点点长大每天都很开心,你能推荐一个好的保险吗?
要多少钱交强险车损险三者险就这三项	保险是多少这三个三个风险
想给孩子买重疾险，保额多少比较好	想买儿童严重疾病风险,多少报道更好
我想给孩子买健康险，一年预算1千的有吗？	我想买健康保险为孩子,有1000年的预算?
我二宝一岁半买重疾险可以吗	我买了两个宝贝一个半沉重的疾病风险
车险到期后换一家保险公司还有优惠吗	保险公司的汽车保险到期的折扣
女儿早产一个月，现在两个月了可以投保健康险吗？	现在女儿早产一个月,两个月支付健康保险?
成人意外险打球意外扭伤能申请意外险理赔吗	成年人玩伤亡事故扭伤可以申请保险索赔
本人是修摩托的可以买意外保险吗	我可以买意外保险是修理自行车
车险玻璃险包括天窗吗	汽车保险风险包括玻璃天窗
机动车损失险是指什么，有必要购买吗	机动车是指是什么损失,有必要购买
底盘被碰撞保险公司能理赔吗	底盘是碰撞保险公司可以索赔
车险第二年怎么买.在哪买	如何购买汽车保险的第二年。
必须的）车损险要不要买	必须覆盖应该买吗
划痕险一年能报几次划痕险最高赔付多少钱	搔抓会开出一年几次风险最高支付很多钱
本人男现在30岁，希望推荐一款保险，同时孩子4个月也想买少儿保险！	我的男性现在30岁,我想推荐一个保险,与此同时,孩子们也要购买儿童保险四个月!
我们公司给我们交了六险一金是指哪些，只听过五险一金	我们公司为我们造六险一金是指什么,只听到五种社会保险和住房公积金
小车车损险加三者险要多少钱	汽车碰撞保险,它是多少
需不需要报保险公司，去4s店需要多少钱	需要不需要保险公司,你需要去4 s店
少儿保险怎么选选择最合适的少儿保险	儿童保险如何选择最适合孩子的保险
保险赔付不超过二千会影响下一年的保费吗?	保险赔偿不超过二千会影响明年的保险费?
强险脱保一年，今年想去交交强险是不是要把去年的补上	强风险TuoBao一年,今年想去支付保险是去年的补上
儿童社保卡要怎么办理	如何处理孩子的社会保障卡
去斯*兰*需要买旅游险吗	蓝色* *,需要买旅行保险
小米少儿保能保哪些重疾	小米儿童保护可以保护什么严重的疾病
汽车商业险50万多少钱	多少汽车业务风险,500000
车险的增值免费服务有哪些	免费增值服务汽车保险是什么
为什么不同的保险公司，保险的价格相差巨大	为什么不同的保险公司,保险价格差别大吗
弘康人寿哆啦a保相对其他产品有什么优势?	香港康生活哆啦a保比其他产品有什么优势?
朋友介绍了安*长*树，不过它有没有等待期？	朋友介绍了安* *树,但是它有等待期吗?
现在的重疾险冲不冲突，已经给老公买了一份了，还能不能买百年人寿家的康惠保？	现在严重疾病的风险不冲突,已经给丈夫买了一个,也可以购买一百康汇宝家庭生活吗?
重疾险怎样骗保险公司	重疾病风险如何欺骗保险公司
我想要一份重疾险，安*长青树重疾险最高可以赔多少呢？	我想严重疾病的风险,安*最高常绿严重疾病的风险可以赔偿多少?
汽车玻璃破了可以走车损险吗	汽车玻璃碎了可以运行覆盖
老婆的康惠保上面要求指定医院是什么意思？	妻子康汇宝需求上面指定的医院是什么意思?
康惠保是不是只能去保险公司进行核保？	只能到保险公司承保Kang汇宝吗?
百年人寿退保流程是怎么样	一百年的生活过程
我的安*长*树已经轻症赔付过了，万一以后再重疾，是不是不能赔付了？	我安* *树有轻微的补偿,一千重疾病,以后可以支付吗?
老公投保的安*长青树理赔难吗？	安*常绿索赔困难的丈夫吗?
自己选购的哆啦A保重疾险，说是保障重疾和轻症，那么老死是不是不保，不是很亏？	你选购的哆啦A保健疾病风险,维护严重疾病和温和,所以老不保护,不失去?
打算买款重疾险，百年人寿康惠保的保障足不足？	打算买重的疾病风险,保证生活的一百年康汇宝足不足?
看见，说哆啦a保可以赔很多次，什么意思？	看到哆啦a保可以失去很多次,你是什么意思?
想要和朋友一起去国外登山攀岩，有没有这类比较好的保险介绍？	想和朋友去爬山,有这样一个好的保险介绍吗?
您好，老公的康惠保线上核保通不过怎么办？	你好,我的丈夫Kang汇宝承销通过在线吗?
朋友介绍了安*长青树重疾险，它怎么样？	朋友介绍了安*常绿沉重的疾病风险,它吗?
百年康惠保是不是寿险？能保多久？	一百年康汇宝人寿保险吗?
我三叔想要投保百年人寿康惠保，投保要知道哪些？	我叔叔想覆盖一百的生活Kang汇宝,确保你知道吗?
哆啦a保重疾险理赔要准备什么？	哆啦a照顾疾病风险调整的准备吗?
那个康惠保保险，已经赔了一次小毛病，担心重疾保额会变少吗？	Kang汇宝保险,已经失去了一个小麻烦,担心会少报道严重的疾病吗?
康惠保重疾险是所有人都可以买吗？对年龄有什么限制？	康威医疗疾病的风险是每个人都可以买吗?
听说有款众行天下保险,这个对滑翔伞这样的运动有保障吗?	听说世界上保险,这保证了滑翔伞运动?
打算带女朋友去芬*看极光，个人去买什么保险好？	*看到极光,女性朋友个人购买保险吗?
本周末公司要和其他企业举办一场职员篮球比赛，保险买什么种类的？	这个周末公司和其他公司职员篮球比赛,什么样的保险购买?
我弟弟身体不大好，能不能给他买弘康哆啦A保？	我弟弟身体不好,你可以给他买香港康哆啦A保?
小姨子的哆啦A保重疾险160种疾病保障，是真的吗？	嫂子哆啦A照顾疾病风险,160种疾病,这是真的吗?
百年人寿康惠保重疾险的特色是什么？	一百生命特征康威医疗疾病的风险?
现在买百年康惠保重疾险，必须要去保险公司弄吗？	现在购买一百康威医疗疾病的风险,必须要到保险公司得到什么?
公司组织团建，举办1天的篮球联赛，什么保险保障比较好？	公司的组织建设、持有1天的篮球联赛,保险是什么更好?
妈妈投保了百年康惠保，可以在线退保吗？	母亲一百年康汇宝覆盖,可以在线贷款吗?
现在的安邦重疾险那个比较实惠点？	现在是沉重的疾病风险,更负担得起的吗?
公司组织一场足球比赛，需要团队买保险，买什么保险比较好？	公司组织一场足球比赛,团队需要买保险、买什么保险好吗?
百年康惠保是消费型的重疾险，是什么意思？	一百年康汇宝是消费严重疾病的风险,是什么意思?
我爸爸想给我买哆啦A保，还准备让我先去体检，麻烦！	我父亲想买我的哆啦A保,也准备让我去医疗麻烦!
我儿子要参加足球比赛，准备给投份保险，什么样的合适	我的儿子将参加足球比赛,为保险
投保了长青树保险，是不是只要理赔过一次就合同就终止了？	确保常绿保险,不是只是声称一旦终止合同?
众行天下户外保险，攀岩可以用吗？	世界的户外保险,攀岩可以使用吗?
叔叔肝炎，哆啦A保会不会拒绝投保？	叔叔肝炎,哆啦A保将拒绝支付?
周末去漂流，除了准备装备之外，什么保险比较可靠？	上周末漂移,除了选矿设备,可靠的保险是什么?
百年康惠保的产品了特色有哪些？小孩子能不能买	一百年康汇宝产品的特点是什么?
众行天下户外保险，可以用于水上运动吗？	世界的户外保险,可用于水上运动吗?
哆啦A保任何地方都可以投吗？	哆啦A保在任何地方扔吗?
今年35了，买重疾险亏不亏	今年35岁,买沉重的疾病可能会失去不是缺陷
老公想要投保康惠保，需要注意什么？	丈夫想确保康汇宝,需要注意什么?
社保性质的重疾险应该怎么办理?	社会保障性质的疾病风险应该如何处理?
境外旅游保险有推荐的吗	建议海外旅行保险
去国外旅游需要买哪些保险	出国旅行需要买什么保险
60种重大疾病保险是哪些？请求专业人士回答	60种重大疾病保险是什么?
我妈四五十岁，有没有合适的重疾险产品？	正确的。
多啦A保是不是性价比最高的重疾	许多拉保是严重疾病的比例最高
我今年刚刚30，想投保一份重疾险，哪款比较好	我今年30岁,想覆盖严重疾病的风险,哪一个更好
有没有口碑比较好的重疾险介绍，我30岁想买	你有口碑好沉重的疾病风险,我想买三十岁的时候
已经有社保，重疾险怎么买合适	如何社会保障、重大疾病保险购买对吗
准备清明节去新*坡旅行，哪款旅游险好？	准备清明节前往新*斜率,旅游保险?
请问下，HUTS中有针对户外运动的保险种类吗	对不起,在小屋户外运动保险类别
重疾险对购买人年龄有没有要求？	严重的疾病风险,买方要求的年龄吗?
重疾险和健康险是一样的吗？买哪种好？	重大疾病保险和医疗保险都是一样的吗?
想知道重疾险,是不是没有出险很亏?	想知道是否重疾病风险,不会或摆脱危险的很不足吗?
闺蜜买了重疾险康惠保还想推荐给我，可以买吗？	最好的朋友买了一个沉重的疾病风险Kang汇宝还想推荐给我,你可以买吗?
当前有哪些寿险公司可以投保重疾险的，介绍下？	什么是当前人寿保险公司覆盖严重疾病的风险,介绍吗?
2018年哪款的重疾险比较好？	2018重疾病风险更好?
慧择的HUTS保险中直升机救援什么情况下可以申请?	明智的选择小屋直升机救援什么情况下可以申请保险吗?
我想请问下，是不是所有的慧择保险都是有huts救援的？？	我想请问,都是明智选择小屋救援保险? ?
家里有社保，还有必要买重疾险吗？	国内社会保障和需要买重疾病风险吗?
买有出险，花钱买了安邦长青树，是不是亏了？	买有危险,支付业务,他们的损失?
HUTS中的自驾游保险有哪些比较好？	小屋的路上是什么保险好吗?
请问下，哆啦A保的轻症豁免是什么意思，不懂	对不起,哆啦A证实轻度豁免是什么意思,不明白
能不能说下安邦长青树重疾险和一般的比有什么优点？	你能说下沉重的疾病风险和一般比有什么优点?
请问康惠保保费便宜会影响理赔吗	请问康汇宝优质廉价的影响
康惠保的保额要买到多少才合适？	康汇宝数量,购买多少?
什么岁数购买重疾险是最好的,麻烦介绍下	风险的最佳年龄是什么买重,麻烦介绍
安邦长青树保险的轻症可以赔付几次？	商业保险轻微可以几次?
我儿子参加少儿运动比赛，有什么保险可以保障？	我的儿子参加孩子们的运动,保险能保证什么?
去国外玩，还会进行一些户外运动，买什么保险好？	出国去玩,也可以做一些户外运动,买什么保险?
康惠保重疾险和一般的重疾险想比,有什么好处?	康威医疗比疾病风险和一般沉重的疾病风险,有什么好处?
安*长青树重疾险买了是不是就不可以退了	安*常绿重疾病风险是买了不能回来
HUTS保险有承保户外运动常见风险的产品吗？	小屋保险常见的户外运动产品的风险吗?
业余比赛保险都提供哪些保障？	业余比赛,保证保险的报价吗?
康惠保保险责任里面的豁免是什么意思呀？	康汇宝保险责任豁免是什么意思?
五一和朋友去香*游玩，有什么保险可以推荐	五一和朋友参观*,什么样的保险可以推荐
什么情况下可以申请huts保险的境内旅行紧急援助服务	什么情况下可以应用小屋旅行保险境内的紧急援助服务
儿子要商务留学，请问huts保险可以有哪些方面的保障	儿子出国留学业务,你能告诉我小屋保险有哪些方面
想问下huts保险畅玩神州-慧择旅游保险可以保障什么？	想问下小屋保险常玩神州——回族可以选择旅游保险保障?
请问下安*长*树*险*院理赔的时候，需要哪些材料	请问安只* * * *树下法院声称,需要什么材料
请问下，安*长青树能够保障哪些？	对不起,安*常绿能保证吗?
请问下康惠保保险在理赔方面对医院有没有什么要求	请问下炕汇宝保险需求方面声称医院
康惠保重疾险到底值不值得投保	康威医疗疾病的风险是值得的
有谁知道，康惠保的健康告知一定要填写吗	谁知道呢,告诉康汇宝健康必须填写吗
公司安排我为期一周的日*商务学习，买什么保险可靠	安排我的为期一周的天*业务学习,购买保险和可靠的
小叔子有病毒性肝炎，是不是百年康惠保这类的保险都不能买了	与病毒性肝炎康汇宝姐夫,一百这种保险是买不到的
这个五一我准备去新*兰探亲买什么HUTS保险好？？	五一我要把新*参观购买小屋什么保险吗? ?
本周末公司会组织200人的户外拓展活动，什么保险能保障员工安全？	这个周末,公司将组织200人户外促销活动,什么样的保险可以保证员工的安全吗?
泰*旅游，购买怎样的保险	泰*旅游、如何购买保险
要出国学术交流，想买份HUTS保险做保障，买什么好？	出国学术交流,想买一个小屋保险,买什么?
请问，有谁知道HUTS的北斗无人区卫星定位是怎么实现的？	对不起,谁知道小屋北斗无人区卫星定位是如何实现?
想问下安邦长青树的犹豫期退保要扣费吗？	想问下这是犹豫期应该放弃他们的指控吗?
请问下哆啦a保值不值得买呢？不晓得保障多不多	哆啦a保值得购买,好吗?
请问下百年康惠保理赔流程是什么样的？	请问下一百康汇宝索赔过程是什么样的?
儿子会去加*大留学，哪款留学生医疗保险好？	儿子要去添加*大留学,拘留学生健康保险?
想出国游玩一段时间，请问有什么申根签证保险	想出国玩一段时间,你能告诉我的申根签证保险
我的康惠保线上核保通不过怎么办？	我的网上承销Kang汇宝通吗?
最近朋友都在说安邦长青树，值得投吗	最近朋友都说与常绿,价值
重疾险有多重要，常见高发的25种重疾包括哪些	如何重要的是沉重的疾病的风险,包括那些常见的高发的25种严重疾病
我儿子还在念小学，适不适合投保康惠保呢？	我的儿子还在小学,封面Kang汇宝兼容吗?
保险公司的理赔环节及步骤一般包括哪些	保险公司理赔环节和步骤一般包括
是不是买了医疗险就不用买康惠保在这类的重疾险了？	我们可以不必买康汇宝买这种严重疾病的风险?
请问下，康惠保是不是去二级以上公立医院就可以了？	对不起,康汇宝二级以上公立医院好吗?
康惠保是买终身的好还是保障到70岁就可以了？	康汇宝是好还是买终身保障到70岁对吧?
投了安邦长青树，给的却是电子保单，这个有效力吗？	扔常绿,电子保单有效?
健康保险除外责任包括哪些方面	医疗保险除外责任包括哪些方面
有哆啦A保,还有社保,得病了这个报销怎么报啊?	哆啦A保,和社会保障,生病的报销报告如何?
端午准备去青*高*玩，带女朋友一起，要什么保险才好？	龙舟绿色高* *玩,和女性朋友,才好要什么保险?
老公投保重疾险被拒,说是六类职业,最近又看了个康惠保,比较担心投不了	丈夫覆盖严重疾病的风险被拒绝,说六个专业,最近看到一个康汇宝,更担心不能
朋友要去美*留学一年，前三个月有没有保险可以保障的	想出国留学的朋友*了一年,做保险的前三个月可以保证
听说康惠保是线上智能核保的，但是不通过，该怎么办？	听到康汇宝在线智能承保,但不通过,我该怎么办?
儿子要去欧*出差，我想给他买份保险，不然不放心	儿子去出差,我想给他买保险,否则不自在
